Macrotone :: Same as Macron.
Xanthoproteic :: "Pertaining to  or derived from  xanthoprotein; showing the characters of xanthopro
Hemastatic :: Alt. of Hemastatical
Scambler :: 1. One who scambles.
Early :: "In advance of the usual or appointed time; in good season; prior in time; among or near th
Ligation :: That which binds; bond; connection.
Hip-roofed :: Having a hip roof.
Fatiferous :: Fate-bringing; deadly; mortal; destructive.
Fixedness :: "The quality of a body which resists evaporation or volatilization by heat; solidity; c
Lackaday :: "Alack the day; alas; -- an expression of sorrow  regret  dissatisfaction  or surprise."
Able-minded :: Having much intellectual power.
Uncertain :: Questionable; equivocal; indefinite; problematical.
Resultance :: The act of resulting; that which results; a result.
Headforemost :: With the head foremost.
Humor :: Changing and uncertain states of mind; caprices; freaks; vagaries; whims.
Unnumbered :: Not numbered; not counted or estimated; innumerable.
Gaseous :: "In the form  or of the nature  of gas  or of an aeriform fluid."
Heel :: A cyma reversa; -- so called by workmen.
Restore :: "To give in place of  or as satisfaction for."
Radiate :: Belonging to the Radiata.
Retell :: To tell again.
Resemblance :: Probability; verisimilitude.
Salinity :: Salineness.
Regaler :: One who regales.
Water pipe :: A pipe for conveying water.
Sea dragon :: The pegasus.
Jemmy :: Spruce.
Affectioned :: Disposed.
Norn :: Alt. of Norna
Taking :: of Take
Glaucous :: "Covered with a fine bloom or fine white powder easily rubbed off  as that on a blue plu
Respectless :: Having no respect; without regard; regardless.
Lap :: "The act of lapping with  or as with  the tongue; as  to take anything into the mouth with a 
Hurried :: of Hurry
Forespent :: Already spent; gone by; past.
Raggy :: Ragged; rough.
Savorly :: Savory.
Vacant :: "Unengaged with business or care; unemployed; unoccupied; disengaged; free; as  vacant hou
Almightful :: Alt. of Almightiful
Abderite :: "An inhabitant of Abdera  in Thrace."
Float :: To pass over and level the surface of with a float while the plastering is kept wet.
Utter :: "Complete; perfect; total; entire; absolute; as  utter ruin; utter darkness."
Respondence :: Alt. of Respondency
Macrencephalic :: Alt. of Macrencephalous
Homogeneous :: "Possessing the same number of factors of a given kind; as  a homogeneous polynomial.
Fordable :: Capable of being forded.
Saturant :: Impregnating to the full; saturating.
Hydrophore :: "An instrument used for the purpose of obtaining specimens of water from any desired d
Fog :: "To show indistinctly or become indistinct  as the picture on a negative sometimes does in th
Sabbaton :: "A round-toed  armed covering for the feet  worn during a part of the sixteenth century 
Gut :: "One of the prepared entrails of an animal  esp. of a sheep  used for various purposes. See C
Nemetean :: Of or pertaining to the Nemertina.
Saturday :: The seventh or last day of the week; the day following Friday and preceding Sunday.
Hards :: The refuse or coarse part of fiax; tow.
Aguish :: Having the qualities of an ague; somewhat cold or shivering; chilly; shaky.
Pachymeningitis :: Inflammation of the dura mater or outer membrane of the brain.
Macrognathic :: Long-jawed.
Fact :: "Reality; actuality; truth; as  he  in fact  excelled all the rest; the fact is  he was beat
Fluence :: Fluency.
Latifoliate :: Alt. of Latifolious
Hour :: The twenty-fourth part of a day; sixty minutes.
Register :: "A certificate issued by the collector of customs of a port or district to the owner of 
Abusive :: Tending to deceive; fraudulent; cheating.
Vagantes :: "A tribe of spiders  comprising some of those which take their prey in a web  but which 
Franking :: of Frank
Babyhouse :: A place for children's dolls and dolls' furniture.
Back :: (Of time) In times past; ago.
Fell :: of Fall
Hoten :: p. p. of Hote.
Adversaries :: of Adversary
Sardoin :: Sard; carnelian.
Reptile :: A groveling or very mean person.
Fasti :: Records or registers of important events.
Formless :: Shapeless; without a determinate form; wanting regularity of shape.
Radius :: "The preaxial bone of the forearm  or brachium  corresponding to the tibia of the hind lim
Uncivility :: Incivility.
Rose water :: Water tinctured with roses by distillation.
Unknow :: Unknown.
Umpire :: "To perform the duties of umpire in or for; as  to umpire a game."
Undertook :: imp. of Undertake.
Revolt :: To cause to turn back; to roll or drive back; to put to flight.
Jockeyism :: The practice of jockeys.
Venatorial :: Or or pertaining to hunting; venatic.
Hardening :: of Harden
Fault :: To charge with a fault; to accuse; to find fault with; to blame.
Flirtigig :: "A wanton  pert girl."
Flotage :: The state of floating.
Verticillate :: Alt. of Verticillated
Abnegator :: "One who abnegates  denies  or rejects anything."
Recapitulation :: "The act of recapitulating; a summary  or concise statement or enumeration  of the
Under-arm :: "Done (as bowling) with the arm not raised above the elbow  that is  not swung far out 
Howdy :: A midwife.
Fourdrinier :: A machine used in making paper; -- so named from an early inventor of improvements in
Harvestry :: "The act of harvesting; also  that which is harvested."
Ribwort :: "A species of plantain (Plantago lanceolata) with long  narrow  ribbed leaves; -- called 
Madefied :: of Madefy
Yonder :: "Being at a distance within view  or conceived of as within view; that or those there; yon
Airy :: Having an affected manner; being in the habit of putting on airs; affectedly grand.
Absorbent :: "The vessels by which the processes of absorption are carried on  as the lymphatics in 
Henotheism :: "Primitive religion in which each of several divinities is regarded as independent  an
Ebonist :: One who works in ebony.
Unlikely :: "Not likely; improbable; not to be reasonably expected; as  an unlikely event; the thing
Sanctities :: of Sanctity
Accident :: "A property or quality of a thing which is not essential to it  as whiteness in paper; a
Wash :: "The blade of an oar  or the thin part which enters the water."
Oat :: A musical pipe made of oat straw.
Pagehood :: The state of being a page.
Abscission :: The state of being cut off.
Forenenst :: Over against; opposite to.
High-principled :: Possessed of noble or honorable principles.
Macroscopic :: Alt. of Macroscopical
Fallowing :: of Fallow
Wardenship :: The office or jurisdiction of a warden.
Uncustomed :: "Uncustomable; also  not having paid duty or customs."
Gainstrive :: To strive or struggle against; to withstand.
Rodsmen :: of Rodsman
Sceneman :: The man who manages the movable scenes in a theater.
Jongler :: "In the Middle Ages  a court attendant or other person who  for hire  recited or sang ver
Scirrhus :: "An indurated organ or part; especially  an indurated gland."
Wainscoted :: of Wainscot
Rebound :: The act of rebounding; resilience.
Restauration :: Restoration.
Gyneocracy :: See Gynecocracy.
Firewood :: Wood for fuel.
Rebate :: "An iron tool sharpened something like a chisel  and used for dressing and polishing wood.
Ferretto :: "Copper sulphide  used to color glass."
Galvanize :: "To coat  as iron  with zinc. See Galvanized iron."
Flocky :: Abounding with flocks; floccose.
Footmen :: of Footman
Note :: "To charge  as with crime (with of or for before the thing charged); to brand."
Foliation :: "The property  possessed by some crystalline rocks  of dividing into plates or slabs  w
Abomination :: "The feeling of extreme disgust and hatred; abhorrence; detestation; loathing; as  he
Heraud :: A herald.
Reptilian :: Belonging to the reptiles.
Fugleman :: "Hence  one who leads the way."
Hyperoartia :: "An order of marsipobranchs including the lampreys. The suckerlike moth contains nume
Havior :: Behavior; demeanor.
Representative :: "A member of the lower or popular house in a State legislature  or in the national
Alpaca :: Wool of the alpaca.
Table d'hote :: A common table for guests at a hotel; an ordinary.
Recarry :: To carry back.
Gy-rose :: "Turned round like a crook  or bent to and fro."
Warhable :: Fit for war.
Free-milling :: "Yielding free gold or silver; -- said of certain ores which can be reduced by crush
Cade :: "To bring up or nourish by hand  or with tenderness; to coddle; to tame."
Nefand :: Alt. of Nefandous
Hackle :: "Any flimsy substance unspun  as raw silk."
Judging :: of Judge
Hermetical :: "Of or pertaining to the system which explains the causes of diseases and the operatio
Admissory :: Pertaining to admission.
Remember :: To mention.
Receipt :: "That which is received; that which comes in  in distinction from what is expended  paid 
Fail :: To be wanting to ; to be insufficient for; to disappoint; to desert.
Noodle :: "A thin strip of dough  made with eggs  rolled up  cut into small pieces  and used in soup
Herald :: "To introduce  or give tidings of  as by a herald; to proclaim; to announce; to foretell; 
Fortition :: Casual choice; fortuitous selection; hazard.
Folding :: of Fold
Roughwork :: "To work over coarsely  without regard to nicety  smoothness  or finish."
Homologoumena :: Those books of the New Testament which were acknowledged as canonical by the early 
Head :: "Culminating point or crisis; hence  strength; force; height."
Forbare :: of Forbear
Guzzle :: "To swallow much or often; to swallow with immoderate gust; to drink greedily or continual
Gage :: "To measure. See Gauge  v. t."
Recti- :: "A combining form signifying straight; as  rectilineal  having straight lines; rectinerved
Fearful :: "Indicating  or caused by  fear."
Fountainless :: Having no fountain; destitute of springs or sources of water.
Farsighted :: Hypermetropic.
Oatmeal :: A plant of the genus Panicum; panic grass.
Headrope :: That part of a boltrope which is sewed to the upper edge or head of a sail.
Wail :: To choose; to select.
Water agrimony :: A kind of bur marigold (Bidens tripartita) found in wet places in Europe.
Naturally :: In a natural manner or way; according to the usual course of things; spontaneously.
Jetson :: "Jettison. See Jettison  1."
Upstare :: "To stare or stand upward; hence  to be uplifted or conspicuous."
Back :: To adjoin behind; to be at the back of.
Scholia :: See Scholium.
Adze :: "A carpenter's or cooper's tool  formed with a thin arching blade set at right angles to the
Fiery :: "Consisting of  containing  or resembling  fire; as  the fiery gulf of Etna; a fiery appear
Fleshhood :: The state or condition of having a form of flesh; incarnation.
Geck :: "Scorn  derision  or contempt."
All-possessed :: Controlled by an evil spirit or by evil passions; wild.
Novelize :: To innovate.
Frequent :: Addicted to any course of conduct; inclined to indulge in any practice; habitual; persis
Race :: "A channel or guide along which a shuttle is driven back and forth  as in a loom  sewing mac
Flews :: "The pendulous or overhanging lateral parts of the upper lip of dogs  especially prominent 
Ghastful :: Fit to make one aghast; dismal.
Harmonize :: "To agree in vocal or musical effect; to form a concord; as  the tones harmonize perfec
Gane :: To yawn; to gape.
Relatedness :: The state or condition of being related; relationship; affinity.
Rate :: Order; arrangement.
Scrutinize :: To make scrutiny.
Religionary :: "Relating to religion; pious; as  religionary professions."
Scapus :: See 1st Scape.
Revellent :: Causing revulsion; revulsive.
Ruinous :: "Causing  or tending to cause  ruin; destructive; baneful; pernicious; as  a ruinous proj
Nontoxic :: Not toxic.
Re-ally :: To bring together again; to compose or form anew.
Homoplasy :: See Homogeny.
Form :: "Mode of acting or manifestation to the senses  or the intellect; as  water assumes the form
Raising :: of Raise
Facile :: Easy to be surmounted or removed; easily conquerable; readily mastered.
Affiancing :: of Affiance
Lister :: "A spear armed with three or more prongs  for striking fish."
Glancing :: of Glance
Rubber :: "In some games  as whist  the odd game  as the third or the fifth  when there is a tie bet
Remitting :: of Remit
Financial :: Pertaining to finance.
Rought :: "imp. of Reck  to care."
Roving :: "A roll or sliver of wool or cotton drawn out and slightly twisted; a rove. See 2d Rove  2
Game fowl :: "A handsome breed of the common fowl  remarkable for the great courage and pugnacity of
Niobic :: Same as Columbic.
Lageniform :: Shaped like a bottle or flask; flag-shaped.
Pack saddle :: Alt. of Pack thread
Unevitable :: Inevitable.
Fringe :: "One of a number of light or dark bands  produced by the interference of light; a diffract
Grecize :: "To render Grecian; also  to cause (a word or phrase in another language) to take a Greek
Jamb :: Any thick mass of rock which prevents miners from following the lode or vein.
Nomarch :: The chief magistrate of a nome or nomarchy.
Ultimatums :: of Ultimatum
Glance :: "To look with a sudden  rapid cast of the eye; to snatch a momentary or hasty view."
Addition :: "Something added to a coat of arms  as a mark of honor; -- opposed to abatement."
Laryngophony :: The sound of the voice as heard through a stethoscope when the latter is placed upon
Generator :: The principal sound or sounds by which others are produced; the fundamental note or roo
Gem :: "A precious stone of any kind  as the ruby  emerald  topaz  sapphire  beryl  spinel  etc.  es
Agitate :: To move or actuate.
Scuta :: of Scutum
Upset :: "Set up; fixed; determined; -- used chiefly or only in the phrase upset price; that is  the
Raver :: One who raves.
Tailored :: of Tailor
Furculum :: "The wishbone or merrythought of birds  formed by the united clavicles."
Fieriness :: "The quality of being fiery; heat; acrimony; irritability; as  a fieriness of temper."
Fang :: "To catch; to seize  as with the teeth; to lay hold of; to gripe; to clutch."
Painful :: Requiring labor or toil; difficult; executed with laborious effort; as a painful service;
Giganticide :: "The act of killing  or one who kills  a giant."
Yare :: Soon.
Reunite :: To unite again; to join after separation or variance.
Rendezvous :: To assemble or meet at a particular place.
Herdswoman :: A woman who tends a herd.
Garbled :: of Garble
Necrosed :: "Affected by necrosis; dead; as  a necrosed bone."
Air bed :: "A sack or matters inflated with air  and used as a bed."
Notopodium :: The dorsal lobe or branch of a parapodium. See Parapodium.
Rockwood :: "Ligniform asbestus; also  fossil wood."
Hautpas :: A raised part of the floor of a large room; a platform for a raised table or throne. See 
Hew :: To cut in pieces; to chop; to hack.
Gymnastic :: A gymnast.
Nilometer :: An instrument for measuring the rise of water in the Nile during its periodical flood.
Hexagynous :: Having six pistils.
Warehouseman :: One who keeps a warehouse; the owner or keeper of a dock warehouse or wharf store.
Ward :: "The act of guarding; watch; guard; guardianship; specifically  a guarding during the day.  
Yode :: Went; walked; proceeded.
Galage :: See Galoche.
Calculating :: The act or process of making mathematical computations or of estimating results.
Cacodoxy :: Erroneous doctrine; heresy; heterodoxy.
Rehash :: "Something hashed over  or made up from old materials."
Agreer :: One who agrees.
Hilltop :: The top of a hill.
Runcation :: A weeding.
Jouissance :: Jollity; merriment.
Abysmally :: To a fathomless depth; profoundly.
Narrow :: "Not to step out enough to the one hand or the other; as  a horse narrows."
Hibernaculum :: Winter home or abiding place.
Grype :: A vulture; the griffin.
Fox :: "To repair the feet of  as of boots  with new front upper leather  or to piece the upper fron
Unslacked :: "Not slacked; unslaked; as  unslacked lime."
Unkempt :: Fig.; Not smoothed; unpolished; rough.
Unbewitch :: To free from a spell; to disenchant.
Gauging rod :: "See Gauge rod  under Gauge  n."
Riled :: of Rile
Hilding :: "A base  menial wretch."
Unessential :: Not essential; not of prime importance; not indispensable; unimportant.
Retrim :: To trim again.
Hooted :: of Hoot
Unworth :: Unworthy.
Velum :: A delicate funnel-like membrane around the flagellum of certain Infusoria. See Illust. a of
Fracas :: An uproar; a noisy quarrel; a disturbance; a brawl.
Roughcaster :: One who roughcasts.
Las :: A lace. See Lace.
Jamaica :: One of the West India is islands.
Hopeless :: Destitute of hope; having no expectation of good; despairing.
Gorging :: of Gorge
Reentry :: "A second or new entry; as  a reentry into public life."
Umbilicated :: Supported by a stalk at the central point.
Honey :: "That which is sweet or pleasant  like honey."
Reflection :: "The transference of an excitement from one nerve fiber to another by means of the ner
Rimey :: To compose in rhyme; to versify.
Haythorn :: Hawthorn.
Roundy :: Round.
Gamosepalous :: Formed of united sepals; monosepalous.
Reconsolidate :: To consolidate anew or again.
Administer :: "To tender  as an oath."
Scrappily :: In a scrappy manner; in scraps.
Hypercriticise :: To criticise with unjust severity; to criticise captiously.
Ladrone :: "A robber; a pirate; hence  loosely  a rogue or rascal."
Numberer :: One who numbers.
Hump :: "A protuberance; especially  the protuberance formed by a crooked back."
Favoress :: A woman who favors or gives countenance.
Utes :: "An extensive tribe of North American Indians of the Shoshone stock  inhabiting Colorado  Ut
-s :: "The suffix used to form the third person singular indicative of English verbs; as in falls  t
Nonvocal :: Not vocal; destitute of tone.
Rong :: imp. &amp; p. p. of Ring.
Nomenclatress :: A female nomenclator.
Saturation :: "The act of saturating  or the state of being saturating; complete penetration or impr
Aggrege :: To make heavy; to aggravate.
Grammar :: To discourse according to the rules of grammar; to use grammar.
Abaisance :: Obeisance.
Lace :: "A snare or gin  especially one made of interwoven cords; a net."
Neif :: Alt. of Neaf
Unplausive :: Not approving; disapproving.
Reclusely :: In a recluse or solitary manner.
Alkanet :: "The similar plant Anchusa officinalis; bugloss; also  the American puccoon."
Rapturist :: An enthusiast.
Roust :: "To rouse; to disturb; as  to roust one out."
Fuscous :: Brown or grayish black; darkish.
Unaffected :: Not affected or moved; destitute of affection or emotion; uninfluenced.
Lambative :: Taken by licking with the tongue.
Gout :: "A disease of cornstalks. See Corn fly  under Corn."
Gramarye :: Necromancy; magic.
Hippurite :: "A fossil bivalve mollusk of the genus Hippurites  of many species  having a conical  c
Hagiarchy :: A sacred government; by holy orders of men.
Alligator :: "Any machine with strong jaws  one of which opens like the movable jaw of an alligator"
Famously :: In a famous manner; in a distinguished degree; greatly; splendidly.
Ne :: Nor.
Regard :: To look attentively; to consider; to notice.
Backer :: "One who  or that which  backs; especially one who backs a person or thing in a contest."
Feeder :: "One who eats or feeds; specifically  an animal to be fed or fattened."
Acceptableness :: "The quality of being acceptable  or suitable to be favorably received; acceptabil
Geocentrically :: In a geocentric manner.
Retruded :: of Retrude
Fiddled :: of Fiddle
Forfeited :: of Forfeit
Regretful :: Full of regret; indulging in regrets; repining.
Riddled :: of Riddle
Root :: "The lowest place  position  or part."
Glycerin :: Alt. of Glycerine
Refuse :: "To decline to accept; to reject; to deny the request or petition of; as  to refuse a suit
School :: The room or hall in English universities where the examinations for degrees and honors are
Untrue :: "Not true; false; contrary to the fact; as  the story is untrue."
Youngling :: Young; youthful.
Unwild :: To tame; to subdue.
Abate :: "To diminish; to reduce. Legacies are liable to be abated entirely or in proportion  upon a
Kayles :: A game; ninepins.
Yokel :: A country bumpkin.
Wae :: A wave.
Hatchment :: "A sort of panel  upon which the arms of a deceased person are temporarily displayed  -
Helmage :: Guidance; direction.
Eccentrical :: See Eccentric.
Schistous :: Of or pertaining to schist; having the structure of a schist.
Reverenced :: of Reverence
Scalene :: Having the sides and angles unequal; -- said of a triangle.
Sea bass :: "A California food fish (Cynoscion nobile); -- called also white sea bass  and sea salmo
Undergo :: To be the bearer of; to possess.
Vainglorious :: Feeling or indicating vainglory; elated by vanity; boastful.
Risen :: Obs. imp. pl. of Rise.
Warbler :: "Any one of numerous species of small  often bright colored  American singing birds of th
Recuperate :: To recover health; to regain strength; to convalesce.
Lena :: A procuress.
Femora :: of Femur
Nitty :: Full of nits.
Neckweed :: "An American annual weed (veronica peregrina)  with small white flowers and a roundish p
Ratify :: "To approve and sanction; to make valid; to confirm; to establish; to settle; especially  
Fervor :: Intensity of feeling or expression; glowing ardor; passion; holy zeal; earnestness.
Valise :: "A small sack or case  usually of leather  but sometimes of other material  for containing
Nonconcurrence :: Refusal to concur.
Rude :: "Unformed by taste or skill; not nicely finished; not smoothed or polished; -- said especial
Alexipyretic :: A febrifuge.
Riotous :: "Involving  or engaging in  riot; wanton; unrestrained; luxurious."
Admiralty :: The office or jurisdiction of an admiral.
Abode :: To be ominous.
Foot :: "A combination of syllables consisting a metrical element of a verse  the syllables being fo
Gastrulae :: of Gastrula
Rift :: To belch.
Heterodont :: "Having the teeth differentiated into incisors  canines  and molars  as in man; -- opp
Ropy :: "capable of being drawn into a thread  as a glutinous substance; stringy; viscous; tenacious
Richesse :: Wealth; riches. See the Note under Riches.
Vexing :: of Vex
Allegorical :: "Belonging to  or consisting of  allegory; of the nature of an allegory; describing b
Madding :: Affected with madness; raging; furious.
Amaryllis :: A pastoral sweetheart.
Rooky :: Misty; gloomy.
Flounce :: "To deck with a flounce or flounces; as  to flounce a petticoat or a frock."
Reappear :: To appear again.
Unready :: To undress.
Gradatory :: "Proceeding step by step  or by gradations; gradual."
Realist :: "An artist or writer who aims at realism in his work. See Realism  2."
Handle :: "To accustom to the hand; to work upon  or take care of  with the hands."
Haunce :: To enhance.
Saving :: Exception; reservation.
Las :: Less.
Renounce :: Act of renouncing.
H :: "The seventh degree in the diatonic scale  being used by the Germans for B natural. See B."
Hylarchical :: Presiding over matter.
Call :: "To utter in a loud or distinct voice; -- often with off; as  to call  or call off  the item
Repugner :: One who repugns.
Numbers :: "pl. of Number. The fourth book of the Pentateuch  containing the census of the Hebrews."
Hydrokinetic :: "Of or pertaining to the motions of fluids  or the forces which produce or affect su
Sclerotic :: "Hard; firm; indurated; -- applied especially in anatomy to the firm outer coat of the 
Fraction :: "To separate by means of  or to subject to  fractional distillation or crystallization; 
Hangnail :: "A small piece or silver of skin which hangs loose  near the root of finger nail."
Foundering :: of Founder
Gephyreoid :: Gephyrean.
Scent :: "To perceive by the olfactory organs; to smell; as  to scent game  as a hound does."
Lay :: Not educated or cultivated; ignorant.
Launch :: "To throw  as a lance or dart; to hurl; to let fly."
Unalmsed :: Not having received alms.
Forking :: of Fork
Vermeil :: A liquid composition applied to a gilded surface to give luster to the gold.
Veered :: of Veer
Scapulet :: A secondary mouth fold developed at the base of each of the armlike lobes of the manubri
Fortieth :: One of forty equal parts into which one whole is divided; the quotient of a unit divided
Cadmian :: See Cadmean.
Adonic :: "Relating to Adonis  famed for his beauty."
Lateres :: of Later
Saltness :: "The quality or state of being salt  or state of being salt  or impregnated with salt; s
Administration :: "The act of administering  or tendering something to another; dispensation; as  th
Garibaldi :: A jacket worn by women; -- so called from its resemblance in shape to the red shirt wor
Noctambulation :: Somnambulism; walking in sleep.
Venereal :: "Adapted to the cure of venereal diseases; as  venereal medicines."
Accredit :: To put or bring into credit; to invest with credit or authority; to sanction.
Tachygraphic :: Alt. of Tachygraphical
Frush :: To batter; to break in pieces.
Wane :: Decline; failure; diminution; decrease; declension.
Palification :: The act or practice of driving piles or posts into the ground to make it firm.
Hustings :: The platform on which candidates for Parliament formerly stood in addressing the elector
Fruitless :: "Lacking  or not bearing  fruit; barren; destitute of offspring; as  a fruitless tree o
Accountability :: The state of being accountable; liability to be called on to render an account; ac
Jointworm :: "The larva of a small  hymenopterous fly (Eurytoma hordei)  which is found in gall-like
Humorless :: Destitute of humor.
Keep :: "To continue in  as a course or mode of action; not to intermit or fall from; to hold to; to
Fatal :: "Proceeding from  or appointed by  fate or destiny; necessary; inevitable."
Sarceled :: Cut through the middle.
Rack :: "A frame or device of various construction for holding  and preventing the waste of  hay  gr
Relic :: "The body from which the soul has departed; a corpse; especially  the body  or some part of
Waken :: To excite or rouse from sleep; to wake; to awake; to awaken.
Raise :: "To cause to arise  grow up  or come into being or to appear; to give rise to; to originate
Abhorrent :: "Abhorring; detesting; having or showing abhorrence; loathing; hence  strongly opposed 
Northwestward :: Alt. of Northwestwardly
Relent :: "To become less severe or intense; to become less hard  harsh  cruel  or the like; to soft
Grip :: "That by which anything is grasped; a handle or gripe; as  the grip of a sword."
Reimpress :: To impress anew.
Sacerdotal :: "Of or pertaining to priests  or to the order of priests; relating to the priesthood; 
Hold :: "To bear  carry  or manage; as he holds himself erect; he holds his head high."
Salian :: Denoting a tribe of Franks who established themselves early in the fourth century on the r
Sax :: A kind of chopping instrument for trimming the edges of roofing slates.
Easter :: "An annual church festival commemorating Christ's resurrection  and occurring on Sunday  t
Grant :: The thing or property granted; a gift; a boon.
Hyperboloid :: Having some property that belongs to an hyperboloid or hyperbola.
Remembrancer :: "One who  or that which  serves to bring to  or keep in  mind; a memento; a memorial
Vernaculous :: Scoffing; scurrilous.
Rest :: Those not included in a proposition or description; the remainder; others.
Unsexed :: of Unsex
Risen :: of Rise
Abominating :: of Abominate
Vicine :: Near; neighboring; vicinal.
Adjective :: Relating to procedure.
Caliginous :: Affected with darkness or dimness; dark; obscure.
Unacquaintance :: The quality or state of being unacquainted; want of acquaintance; ignorance.
Ligature :: "The state of being bound or stiffened; stiffness; as  the ligature of a joint."
Pain :: Uneasiness of mind; mental distress; disquietude; anxiety; grief; solicitude; anguish.
Unbelieved :: Not believed; disbelieved.
Saw :: Something said; speech; discourse.
Ecbasis :: A figure in which the orator treats of things according to their events consequences.
Hear :: To accede to the demand or wishes of; to listen to and answer favorably; to favor.
Easterling :: "Relating to the money of the Easterlings  or Baltic traders. See Sterling."
Variant :: "Varying in from  character  or the like; variable; different; diverse."
Hanap :: "A rich goblet  esp. one used on state occasions."
Zincane :: Zinc chloride.
Get :: "To arrive at  or bring one's self into  a state  condition  or position; to come to be; to b
Repelling :: of Repel
Gravamina  :: of Gravamen
Ninnyhammer :: A simpleton; a silly person.
Ad captandum :: A phrase used adjectively sometimes of meretricious attempts to catch or win popular
Fourthly :: In the fourth place.
Wasteful :: Waste; desolate; unoccupied; untilled.
Jugulate :: To cut the throat of.
Adiaphorous :: "Incapable of doing either harm or good  as some medicines."
Jean :: A twilled cotton cloth.
Heredity :: Hereditary transmission of the physical and psychical qualities of parents to their offs
Undershrievalty :: The office or position of an undersheriff.
Haemacyanin :: "A substance found in the blood of the octopus  which gives to it its blue color."
Remitter :: "The sending or placing back of a person to a title or right he had before; the restitut
Adventure :: "A remarkable occurrence; a striking event; a stirring incident; as  the adventures of 
Bactericidal :: Destructive of bacteria.
Revivalistic :: Pertaining to revivals.
Flatter :: "To raise hopes in; to encourage or favorable  but sometimes unfounded or deceitful  repr
Foul :: "Loathsome; disgusting; as  a foul disease."
Sconce :: A fragment of a floe of ice.
Retinulae :: of Retinula
Grow :: To increase in any way; to become larger and stronger; to be augmented; to advance; to exten
Repute :: To hold in thought; to account; to estimate; to hold; to think; to reckon.
Yachting :: Sailing for pleasure in a yacht.
Forebeam :: The breast beam of a loom.
Rejectitious :: Implying or requiring rejection; rejectable.
Age :: A long time.
Hemitone :: See Semitone.
Administer :: To contribute; to bring aid or supplies; to conduce; to minister.
Hall :: "A vestibule  entrance room  etc.  in the more elaborated buildings of later times."
Gush :: "A sentimental exhibition of affection or enthusiasm  etc.; effusive display of sentiment."
Homophony :: Sameness of sound.
Admixture :: The compound formed by mixing different substances together.
Liegiancy :: See Ligeance.
Unsped :: Not performed; not dispatched.
Norie :: The cormorant.
Recontinue :: To continue anew.
Halt :: "To stand in doubt whether to proceed  or what to do; to hesitate; to be uncertain."
Red :: A red pigment.
Adread :: To dread.
Screw :: "A cylinder  or a cylindrical perforation  having a continuous rib  called the thread  wind
Rhabdom :: "One of numerous minute rodlike structures formed of two or more cells situated behind th
Earing :: A line fastening the corners of an awning to the rigging or stanchions.
Seabound :: Bounded by the sea.
Habitability :: Habitableness.
Universalized :: of Universalize
Rescussee :: The party in whose favor a rescue is made.
Salework :: "Work or things made for sale; hence  work done carelessly or slightingly."
Recoilingly :: In the manner of a recoil.
Jetty :: To jut out; to project.
Aeronaut :: An aerial navigator; a balloonist.
Glib :: To castrate; to geld; to emasculate.
Napoleonic :: "Of or pertaining to Napoleon I.  or his family; resembling  or having the qualities o
Garble :: Refuse; rubbish.
Liberalized :: of Liberalize
Kempe :: Rough; shaggy.
Round :: "To bring to fullness or completeness; to complete; hence  to bring to a fit conclusion."
Resemblance :: The quality or state of resembling; likeness; similitude; similarity.
Hydra :: "Any small fresh-water hydroid of the genus Hydra  usually found attached to sticks  stones
Gymnosperm :: "A plant that bears naked seeds (i. e.  seeds not inclosed in an ovary)  as the common
New :: "Not of ancient extraction  or of a family of ancient descent; not previously kniwn or famous
Adhesion :: The molecular attraction exerted between bodies in contact. See Cohesion.
Admittance :: "Concession; admission; allowance; as  the admittance of an argument."
Alfet :: A caldron of boiling water into which an accused person plunged his forearm as a test of in
Lazing :: of Laze
Jasp :: Jasper.
Light :: "A firework made by filling a case with a substance which burns brilliantly with a white or
Obbe :: See Obi.
Cackling :: of Cackle
Unsuspicion :: The quality or state of being unsuspecting.
Ramble :: "To talk or write in a discursive  aimless way."
Filchingly :: By pilfering or petty stealing.
Ventricular :: Of or pertaining to a ventricle; bellied.
Fit :: The part of an object upon which anything fits tightly.
Granulation :: "One of the small  red  grainlike prominences which form on a raw surface (that of wo
Gules :: "The tincture red  indicated in seals and engraved figures of escutcheons by parallel verti
Redrawing :: of Redraw
Allowance :: Acknowledgment.
Gypseous :: Resembling or containing gypsum; partaking of the qualities of gypsum.
Velure :: Velvet.
Harem :: The apartments or portion of the house allotted to females in Mohammedan families.
Rigging :: "DRess; tackle; especially (Naut.)  the ropes  chains  etc.  that support the masts and s
High-fed :: Pampered; fed luxuriously.
Jaeger :: See Jager.
Holophotal :: Causing no loss of light; -- applied to reflectors which throw back the rays of light 
Grate :: "A frame or bed  or kind of basket  of iron bars  for holding fuel while burning."
Represser :: "One who  or that which  represses."
Hydrus :: "A constellation of the southern hemisphere  near the south pole."
Unbishop :: "To deprive  as a city  of a bishop; to deprive  as a clergyman  of episcopal dignity or
Galvanize :: "To restore to consciousness by galvanic action (as from a state of suspended animation
Redundancy :: The quality or state of being redundant; superfluity; superabundance; excess.
Female :: "An individual of the sex which conceives and brings forth young  or (in a wider sense) wh
Leaf-footed :: "Having leaflike expansions on the legs; -- said of certain insects; as  the leaf-foo
Floricomous :: Having the head adorned with flowers.
Gradus :: "A dictionary of prosody  designed as an aid in writing Greek or Latin poetry."
Geniculation :: The state of being bent abruptly at an angle.
Absorption :: "Entire engrossment or occupation of the mind; as  absorption in some employment."
Scenograph :: A perspective representation or general view of an object.
Noteworthy :: Worthy of observation or notice; remarkable.
Reframe :: To frame again or anew.
Rub :: "To fret; to chafe; as  to rub upon a sore."
Rub :: Imperfection; failing; fault.
Scrub :: "To rub hard; to wash with rubbing; usually  to rub with a wet brush  or with something coa
Launder :: A washerwoman.
Heterodromous :: Having spirals of changing direction.
Goiter :: Alt. of Goitre
Gonophore :: "A sexual zooid produced as a medusoid bud upon a hydroid  sometimes becoming a free hy
Raised :: "Leavened; made with leaven  or yeast; -- used of bread  cake  etc.  as distinguished from
Grail :: One of the small feathers of a hawk.
Abattis :: "A means of defense formed by felled trees  the ends of whose branches are sharpened and 
Resound :: To be mentioned much and loudly.
Salt :: A sailor; -- usually qualified by old.
Table :: "A smooth  flat surface  like the side of a board; a thin  flat  smooth piece of anything; 
Keelhaul :: "To haul under the keel of a ship  by ropes attached to the yardarms on each side. It wa
Vat :: To put or transfer into a vat.
Abjudge :: To take away by judicial decision.
Gettable :: That may be obtained.
Upstir :: Insurrection; commotion; disturbance.
Laystall :: "A place where rubbish  dung  etc.  are laid or deposited."
Savage :: "A man of extreme  unfeeling  brutal cruelty; a barbarian."
Advanced :: In the van or front.
Hyoideal :: Alt. of Hyoidean
Gracious :: "Abounding in grace or mercy; manifesting love . or bestowing mercy; characterized by gr
Hammer :: "To beat with a hammer; to beat with heavy blows; as  to hammer iron."
Vestal :: "A virgin consecrated to Vesta  and to the service of watching the sacred fire  which was 
Horrisonant :: Horrisonous.
Huke :: An outer garment worn in Europe in the Middle Ages.
Heteroclite :: "Any thing or person deviating from the common rule  or from common forms."
Kerned :: Having part of the face projecting beyond the body or shank; -- said of type.
Hemitropal :: Alt. of Hemitropous
Achromatin :: Tissue which is not stained by fluid dyes.
Sea poppy :: The horn poppy. See under Horn.
Repent :: "To feel pain  sorrow  or regret  for what one has done or omitted to do."
Resider :: One who resides in a place.
Unlock :: "To unfasten  as what is locked; as  to unlock a door or a chest."
Nauseating :: of Nauseate
Sagenitic :: "Resembling sagenite; -- applied to quartz when containing acicular crystals of other m
Adjuration :: "The act of adjuring; a solemn charging on oath  or under the penalty of a curse; an e
Jocose :: "Given to jokes and jesting; containing a joke  or abounding in jokes; merry; sportive; hu
Aerification :: "The act of becoming aerified  or of changing from a solid or liquid form into an ae
Walk :: "To move along on foot; to advance by steps; to go on at a moderate pace; specifically  of t
Aftermost :: Hindmost; -- opposed to foremost.
Nippitato :: Strong liquor.
Hussy :: A worthless woman or girl; a forward wench; a jade; -- used as a term of contempt or reproa
Reviewable :: Capable of being reviewed.
Hibernian :: A native or an inhabitant of Ireland.
Abasement :: "The act of abasing  humbling  or bringing low; the state of being abased or humbled; h
Upset :: To become upset.
Unguiculate :: Alt. of Unguiculated
Lacerti :: of Lacertus
Acronyc :: Alt. of Acronychal
Nipple :: "A pipe fitting  consisting of a short piece of pipe  usually provided with a screw thread
Lapidary :: "Of or pertaining to monumental inscriptions; as  lapidary adulation."
Fellowshiped :: of Fellowship
Glass-faced :: Mirror-faced; reflecting the sentiments of another.
Aigret :: Alt. of Aigrette
Restrain :: To withhold; to forbear.
Jacobinical :: "Of or pertaining to the Jacobins of France; revolutionary; of the nature of  or char
Gilt :: "A female pig  when young."
Y- :: "A prefix of obscure meaning  originally used with verbs  adverbs  adjectives  nouns  and pron
Affiliation :: Adoption; association or reception as a member in or of the same family or society.
Green :: Having a sickly color; wan.
Language :: "The expression of ideas by writing  or any other instrumentality."
Unsay :: "To recant or recall  as what has been said; to refract; to take back again; to make as if 
Oar :: An oarlike swimming organ of various invertebrates.
Jaunt :: To ramble here and there; to stroll; to make an excursion.
Sea lily :: A crinoid.
Abstraction :: The taking surreptitiously for one's own use part of the property of another; purloin
Roaringly :: In a roaring manner.
Henceforth :: From this time forward; henceforward.
Undergroan :: To groan beneath.
Gimmor :: A piece of mechanism; mechanical device or contrivance; a gimcrack.
Sainted :: Entered into heaven; -- a euphemism for dead.
Verbenate :: "To strew with verbena  or vervain  as in ancient sacrifices and rites."
Rifle :: "To grove; to channel; especially  to groove internally with spiral channels; as  to rifle 
Guiltiness :: The quality or state of being guilty.
Jilt :: To play the jilt; to practice deception in love; to discard lovers capriciously.
Raddle :: "A red pigment used in marking sheep  and in some mechanical processes; ruddle."
Nation :: "The body of inhabitants of a country  united under an independent government of their own
Hectocotylus :: "One of the arms of the male of most kinds of cephalopods  which is specially modifi
Gimp :: Smart; spruce; trim; nice.
Hypodicrotic :: Alt. of Hypodicrotous
Uranographic :: Alt. of Uranographical
Fringilline :: Pertaining to the family Fringillidae; characteristic of finches; sparrowlike.
Adays :: "By day  or every day; in the daytime."
Usquebaugh :: "A liquor compounded of brandy  or other strong spirit  raisins  cinnamon and other sp
Napoleon :: "A French gold coin of twenty francs  or about $3.86."
Unpeered :: Having no peer; unequaled; unparalleled.
Aerographer :: One versed in aeography: an aerologist.
Rug-headed :: Having shaggy hair; shock-headed.
Adry :: In a dry or thirsty condition.
Abutment :: That on or against which a body abuts or presses
Utterable :: Capable of being uttered.
Absolve :: To finish; to accomplish.
Laniary :: "Lacerating or tearing; as  the laniary canine teeth."
Recrement :: Excrement.
Just :: "Rendering or disposed to render to each one his due; equitable; fair; impartial; as  just j
Vanish :: "The brief terminal part of vowel or vocal element  differing more or less in quality from
Unlaid :: Not allayed; not pacified; not laid finally to rest.
Agast :: Alt. of Aghast
Junk :: "A large vessel  without keel or prominent stem  and with huge masts in one piece  used by t
Fatigate :: Wearied; tired; fatigued.
Unmorrised :: Not arrayed in the dress of a morris dancer.
Yellowfin :: A large squeteague.
Oatcake :: A cake made of oatmeal.
Warm :: "Having yellow or red for a basis  or in their composition; -- said of colors  and opposed t
Garland :: "A wreath of chaplet made of branches  flowers  or feathers  and sometimes of precious st
Actiniae :: of Actinia
Horn :: "A symbol of strength  power  glory  exaltation  or pride."
Nog :: One of the square logs of wood used in a pile to support the roof of a mine.
Vector :: Same as Radius vector.
Frontal :: A little pediment over a door or window.
Judicial :: "Fitted or apt for judging or deciding; as  a judicial mind."
Funded :: "Existing in the form of bonds bearing regular interest; as  funded debt."
Palmiferous :: Bearing palms.
Fomentation :: The lotion applied to a diseased part.
Heliotrope :: See Bloodstone (a).
Noise :: "Music  in general; a concert; also  a company of musicians; a band."
Retorted :: of Retort
Calibrate :: "To ascertain the caliber of  as of a thermometer tube; also  more generally  to determ
Handing :: of Hand
Hepatorenal :: "Of or pertaining to the liver and kidneys; as  the hepatorenal ligament."
Ration :: "A fixed daily allowance of provisions assigned to a soldier in the army  or a sailor in t
Unformed :: "Decomposed  or resolved into parts; having the form destroyed."
Heeltapped :: of Heeltap
Say :: To try; to assay.
Grandchild :: A son's or daughter's child; a child in the second degree of descent.
Filled :: of Fill
Viciosity :: Vitiosity.
Warden :: "An officer who keeps or guards; a keeper; as  the warden of a prison."
Underwear :: That which is worn under the outside clothing; underclothes.
Giffgaff :: Mutial accommodation; mutual giving.
Ramrod :: The rod used in ramming home the charge in a muzzle-loading firearm.
Rivalries :: of Rivalry
Waste :: "To procure or sustain a reduction of flesh; -- said of a jockey in preparation for a race 
Yak :: "A bovine mammal (Poephagus grunnies) native of the high plains of Central Asia. Its neck  th
Hurryingly :: In a hurrying manner.
Necked :: "Having (such) a neck; -- chiefly used in composition; as  stiff-necked."
Genus :: "A class of objects divided into several subordinate species; a class more extensive than a
Uncomplete :: Incomplete.
Fare :: "The price of passage or going; the sum paid or due for conveying a person by land or water;
Adroit :: "Dexterous in the use of the hands or in the exercise of the mental faculties; exhibiting 
Hostility :: State of being hostile; public or private enemy; unfriendliness; animosity.
Hornpipe :: "A lively tune played on a hornpipe  for dancing; a tune adapted for such playing."
Water soldier :: An aquatic European plant (Stratiotes aloides) with bayonet-shaped leaves.
January :: "The first month of the year  containing thirty-one days."
Raiding :: of Raid
Cadenza :: "A parenthetic flourish or flight of ornament in the course of a piece  commonly just bef
Unlust :: Listlessness; disinclination.
Frail :: "The quantity of raisins -- about thirty-two  fifty-six  or seventy-five pounds  -- contain
Heartbreaking :: Causing overpowering sorrow.
Ladies' eardrops :: "The small-flowered Fuchsia (F. coccinea)  and other closely related species."
Absorptiveness :: The quality of being absorptive; absorptive power.
No-man's land :: Fig.: An unclaimed space or time.
Labor :: To be in travail; to suffer the pangs of childbirth.
Abode :: An omen.
Foiling :: of Foil
Variant :: Changeable; changing; fickle.
Acraspeda :: "A group of acalephs  including most of the larger jellyfishes; the Discophora."
Labarum :: "The standard adopted by the Emperor Constantine after his conversion to Christianity. It
Flittingly :: In a flitting manner.
Realize :: "To convert into real property; to make real estate of; as  to realize his fortune."
Kiddow :: The guillemot.
Utility :: "Adaptation to satisfy the desires or wants; intrinsic value. See Note under Value  2."
Humidness :: Humidity.
Sabering :: of Sabre
Nipping :: of Nip
Acquaintable :: Easy to be acquainted with; affable.
Racket-tailed :: "Having long and spatulate  or racket-shaped  tail feathers."
Grecizing :: of Grecize
Warden :: A keeper; a guardian; a watchman.
Acclimation :: "The process of becoming  or the state of being  acclimated  or habituated to a new c
Salad :: "A dish composed of chopped meat or fish  esp. chicken or lobster  mixed with lettuce or ot
Lied :: "A lay; a German song. It differs from the French chanson  and the Italian canzone  all thre
Rammer :: "An instrument for driving anything with force; as  a rammer for driving stones or piles  
Washing :: The act of one who washes; the act of cleansing with water; ablution.
Alpia :: "The seed of canary grass (Phalaris Canariensis)  used for feeding cage birds."
Laevorotatory :: Same as Levorotatory.  Cf. Dextrorotatory.
Gloria :: "A doxology (beginning Gloria Patri  Glory be to the Father)  sung or said at the end of t
Lethargizing :: of Lethargize
Affection :: "A settled good will; kind feeling; love; zealous or tender attachment; -- often in the
Norwegium :: "A rare metallic element  of doubtful identification  said to occur in the copper-nicke
Reaffirmation :: A second affirmation.
Juwise :: Same as Juise.
Foyer :: A lobby in a theater; a greenroom.
Fistula :: A reed; a pipe.
Run :: "To have a course or direction; as  a line runs east and west."
Flatuous :: Windy; generating wind.
Vetchy :: Consisting of vetches or of pea straw.
Zest :: "A piece of orange or lemon peel  or the aromatic oil which may be squeezed from such peel  
Juwansa :: The camel's thorn. See under Camel.
Levied :: of Levy
Gudgeon :: What may be got without skill or merit.
Fetidness :: The quality or state of being fetid.
Radix :: "A finite expression  from which a series is derived."
Unstriped :: "Without marks or striations; nonstriated; as  unstriped muscle fibers."
First-class :: "Of the best class; of the highest rank; in the first division; of the best quality; 
Report :: "To write an account of for publication  as in a newspaper; as  to report a public celebra
Retrograde :: "Tending or moving backward; having a backward course; contrary; as  a retrograde moti
Accurse :: To devote to destruction; to imprecate misery or evil upon; to curse; to execrate; to ana
Foin :: "A kind of fur  black at the top on a whitish ground  taken from the ferret or weasel of the
Near :: "Close to anything followed or imitated; not free  loose  or rambling; as  a version near to
Gorge :: The throat; the gullet; the canal by which food passes to the stomach.
Rote :: To go out by rotation or succession; to rotate.
Foil :: To defile; to soil.
Aetites :: See Eaglestone.
Verbarium :: "A game in word making.  See Logomachy  2."
Faculty :: Power; prerogative or attribute of office.
Housewifely :: Pertaining or appropriate to a housewife; domestic; economical; prudent.
Unlatched :: of Unlatch
Him :: Them. See Hem.
Lambdoidal :: Same as Lambdoid.
Herderite :: "A rare fluophosphate of glucina  in small white crystals."
Bacillar :: Shaped like a rod or staff.
Scant :: "To cut short; to make small  narrow  or scanty; to curtail."
Runt :: "A dwarf; also  a mean  despicable  boorish person; -- used opprobriously."
Vernier :: "A short scale made to slide along the divisions of a graduated instrument  as the limb o
Sacramentalism :: The doctrine and use of sacraments; attachment of excessive importance to sacramen
Frail :: Easily broken; fragile; not firm or durable; liable to fail and perish; easily destroyed; n
Warner :: A warrener.
Flaggy :: Weak; flexible; limber.
Rattle-headed :: Noisy; giddy; unsteady.
Hymeneal :: Alt. of Hymenean
Baccalaureate :: "The degree of bachelor of arts. (B.A. or A.B.)  the first or lowest academical deg
Genette :: "The fur of the common genet (Genetta vulgaris); also  any skin dressed in imitation of t
Restorationist :: One who believes in a temporary future punishment and a final restoration of all t
Acroatic :: Same as Acroamatic.
Taintless :: Free from taint or infection; pure.
Ungodly :: Polluted by sin or wickedness.
Religiously :: In a religious manner.
Rill :: A very small brook; a streamlet.
Homology :: "The correspondence or resemblance of substances belonging to the same type or series; a
Vacancy :: "The quality or state of being vacant; emptiness; hence  freedom from employment; intermi
Grouse :: To complain or grumble.
Water newt :: Any one of numerous species of aquatic salamanders; a triton.
Giblet :: "Made of giblets; as  a giblet pie."
Hack :: Hackneyed; hired; mercenary.
Form :: "The particular shape or structure of a word or part of speech; as  participial forms; verba
Norm :: "A typical  structural unit; a type."
Waken :: To wake; to cease to sleep; to be awakened.
Homologinic :: "Pertaining to  or characterized by  homology; as  homologinic qualities  or differen
Fleecing :: of Fleece
Huggle :: To hug.
Unseven :: To render other than seven; to make to be no longer seven.
Fob :: To beat; to maul.
Lawsonia :: "An Asiatic and North African shrub (Lawsonia inermis)  with smooth oval leaves  and fra
Raid :: A hostile or predatory incursion; an inroad or incursion of mounted men; a sudden and rapid 
Water rate :: A rate or tax for a supply of water.
Hognut :: "In England  the Bunium flexuosum  a tuberous plant."
Caesar :: "A Roman emperor  as being the successor of Augustus Caesar. Hence  a kaiser  or emperor o
Guna :: "In Sanskrit grammar  a lengthening of the simple vowels a  i  e  by prefixing an a element.
Rear-horse :: A mantis.
Pageant :: To exhibit in show; to represent; to mimic.
Hurst :: "A wood or grove; -- a word used in the composition of many names  as in Hazlehurst."
Fur :: "The short  fine  soft hair of certain animals  growing thick on the skin  and distinguished 
Rat :: To catch or kill rats.
Allhallow :: Alt. of Allhallows
Fly :: "Any dipterous insect; as  the house fly; flesh fly; black fly. See Diptera  and Illust. in A
Nineteenth :: Constituting or being one of nineteen equal parts into which anything is divided.
Glazy :: Having a glazed appearance; -- said of the fractured surface of some kinds of pin iron.
Sanguification :: The production of blood; the conversion of the products of digestion into blood; h
Golden :: "Very precious; highly valuable; excellent; eminently auspicious; as  golden opinions."
Needless :: Having no need.
Rhigolene :: "A mixture of volatile hydrocarbons intermediate between gsolene and cymogene. It is ob
Unibranchiate :: "Having but one gill  as certain molluscs."
Force :: To use violence; to make violent effort; to strive; to endeavor.
Hollandish :: Relating to Holland; Dutch.
Hase :: "See Haze  v. t."
Hatting :: "The business of making hats; also  stuff for hats."
Rampion :: "A plant (Campanula Rapunculus) of the Bellflower family  with a tuberous esculent root; 
Varix :: One of the prominent ridges or ribs extending across each of the whorls of certain univalve
Sallyman :: The velella; -- called also saleeman.
Geometric :: Alt. of Geometrical
Water pillar :: A waterspout.
Gothic :: "Of or pertaining to a style of architecture with pointed arches  steep roofs  windows lar
Earthy :: "Without luster  or dull and roughish to the touch; as  an earthy fracture."
Latitudinarian :: Not restrained; not confined by precise limits.
Levitical :: Of or pertaining to a Levite or the Levites.
Unused :: Not habituated; unaccustomed.
Furhelow :: To put a furbelow on; to ornament.
Calces :: See Calx.
Gentianose :: "A crystallizable  sugarlike substance  with a slightly sweetish taste  obtained from 
Satisfaction :: "Settlement of a claim  due  or demand; payment; indemnification; adequate compensat
Hyperoxymuriate :: A perchlorate.
Air :: "The fluid which we breathe  and which surrounds the earth; the atmosphere. It is invisible  
Noble-minded :: Having a noble mind; honorable; magnanimous.
Gabeler :: A collector of gabels or taxes.
Foot :: To tread to measure or music; to dance; to trip; to skip.
Abort :: "To become checked in normal development  so as either to remain rudimentary or shrink away
Calamistration :: The act or process of curling the hair.
Abstrusity :: Abstruseness; that which is abstruse.
Falchion :: "A name given generally and poetically to a sword  especially to the swords of Oriental 
Repudiate :: "To divorce  put away  or discard  as a wife  or a woman one has promised to marry."
Fowler :: "A sportsman who pursues wild fowl  or takes or kills for food."
Follow :: "To walk in  as a road or course; to attend upon closely  as a profession or calling."
Varnish :: An artificial covering to give a fair appearance to any act or conduct; outside show; glo
Runt :: "The dead stump of a tree; also  the stem of a plant."
Holocaust :: "A burnt sacrifice; an offering  the whole of which was consumed by fire  among the Jew
Abate :: "To bring down or reduce from a higher to a lower state  number  or degree; to lessen; to d
Undertook :: of Undertake
Wasteful :: "Full of waste; destructive to property; ruinous; as  wasteful practices or negligence; 
Umbra :: "The central dark portion  or nucleus  of a sun spot."
Sanative :: Having the power to cure or heal; healing; tending to heal; sanatory.
Afreet :: "A powerful evil jinnee  demon  or monstrous giant."
Flibbergib :: A sycophant.
Agent :: "Acting; -- opposed to patient  or sustaining  action."
Germanic :: "Of or pertaining to Germany; as  the Germanic confederacy."
Umbilicate :: Alt. of Umbilicated
Adamite :: "One of a sect of visionaries  who  professing to imitate the state of Adam  discarded th
Madonna :: A picture of the Virgin Mary (usually with the babe).
Rase :: To rub or scratch out; to erase.
Radish :: "The pungent fleshy root of a well-known cruciferous plant (Raphanus sativus); also  the w
Zero :: A cipher; nothing; naught.
Grub :: "A short  thick man; a dwarf."
Harrow :: "An implement of agriculture  usually formed of pieces of timber or metal crossing each ot
Feebleness :: The quality or condition of being feeble; debility; infirmity.
Guardsman :: "A member  either officer or private  of any military body called Guards."
Lethargy :: To lethargize.
Fellmonger :: "A dealer in fells or sheepskins  who separates the wool from the pelts."
Unlikely :: In an unlikely manner.
Haunt :: To accustom; to habituate.
Warp :: To wind yarn off bobbins for forming the warp of a web; to wind a warp on a warp beam.
Alguazil :: An inferior officer of justice in Spain; a warrant officer; a constable.
Lanciname :: To tear; to lacerate; to pierce or stab.
Recast :: "To mold anew; to cast anew; to throw into a new form or shape; to reconstruct; as  to rec
Hip :: "The external angle formed by the meeting of two sloping sides or skirts of a roof  which hav
Unshelve :: "To remove from  or as from  a shelf."
Unty :: To untie.
Gallows :: A pair of suspenders or braces.
Flowerer :: A plant which flowers or blossoms.
Readopt :: To adopt again.
Upcaught :: Seized or caught up.
Kantist :: A disciple or follower of Kant.
Salination :: The act of washing with salt water.
Salivary :: "Of or pertaining to saliva; producing or carrying saliva; as  the salivary ferment; the
Resplendishing :: Resplendent.
Flitted :: of Flit
Fugue :: "A polyphonic composition  developed from a given theme or themes  according to strict cont
Iambic :: An iambic foot; an iambus.
Gun :: "A piece of heavy ordnance; in a restricted sense  a cannon."
Rip :: "A rent made by ripping  esp. by a seam giving way; a tear; a place torn; laceration."
Abuseful :: Full of abuse; abusive.
Saxatile :: "Of or pertaining to rocks; living among rocks; as  a saxatile plant."
Unload :: "To perform the act of unloading anything; as  let unload now."
Redeemed :: of Redeem
Abnegation :: a denial; a renunciation.
Unroofed :: Not yet roofed.
Ferocity :: "Savage wildness or fierceness; fury; cruelty; as  ferocity of countenance."
Unlocated :: Not located or placed; not fixed in a place.
Fiction :: "The act of feigning  inventing  or imagining; as  by a mere fiction of the mind."
Raiae :: "The order of elasmobranch fishes which includes the sawfishes  skates  and rays; -- called
Naphthoquinone :: "A yellow crystalline substance  C10H6O2  analogous to quinone  obtained by oxidiz
Fall :: "Downfall; degradation; loss of greatness or office; termination of greatness  power  or dom
Gowdie :: See Dragont.
Scholiast :: A maker of scholia; a commentator or annotator.
Utilization :: "The act of utilizing  or the state of being utilized."
Full-sailed :: "Having all its sails set ; hence  without restriction or reservation."
Road :: An inroad; an invasion; a raid.
Scalawag :: A scamp; a scapegrace.
Unbedinned :: Not filled with din.
Foveolae :: of Foveola
Rostrum :: The beak or head of a ship.
Leany :: Lean.
Heroship :: The character or personality of a hero.
Refurbish :: To furbish anew.
Paleotheroid :: Resembling Paleotherium.
Henotic :: Harmonizing; irenic.
Reasonably :: Moderately; tolerably.
Universalist :: Of or pertaining to Unversalists of their doctrines.
Undersky :: The lower region of the sky.
Faithless :: Not believing; not giving credit.
Underbearer :: "One who supports or sustains; especially  at a funeral  one of those who bear the co
Form :: "To derive by grammatical rules  as by adding the proper suffixes and affixes."
Scaphognathite :: A thin leafike appendage (the exopodite) of the second maxilla of decapod crustace
Formative :: "Capable of growth and development; germinal; as  living or formative matter."
Falconet :: One of several very small Asiatic falcons of the genus Microhierax.
Respiring :: of Respire
Resend :: "To send again; as  to resend a message."
Gormandized :: of Gormandize
Gallery :: "A long and narrow corridor  or place for walking; a connecting passageway  as between on
Alloo :: To incite dogs by a call; to halloo.
Lethe :: A river of Hades whose waters when drunk caused forgetfulness of the past.
Urosternite :: "The sternal  or under piece  of any one of the uromeres of insects and other arthrop
Regiment :: A region or district governed.
Roofing :: "The wedging  as of a horse or car  against the top of an underground passage."
Jugger :: An East Indian falcon. See Lugger.
Unqueen :: To divest of the rank or authority of queen.
Vesicle :: "A small bladderlike body in the substance of vegetable  or upon the surface of a leaf."
Haemic :: Pertaining to the blood; hemal.
Agglutinating :: of Agglutinate
Garter :: A band used to prevent a stocking from slipping down on the leg.
Frontal :: "Of or pertaining to the forehead or the anterior part of the roof of the brain case; as 
Samette :: See Samite.
Lascivious :: Tending to produce voluptuous or lewd emotions.
Fretted :: Agitated; vexed; worried.
Land :: "The mainland  in distinction from islands."
Retort :: To throw back; to reverberate; to reflect.
Grum :: Morose; severe of countenance; sour; surly; glum; grim.
Hesitating :: of Hesitate
Helpless :: Bringing no help; unaiding.
Active :: "Brisk; lively; as  an active demand for corn."
Scrunch :: To scranch; to crunch.
Reremouse :: A rearmouse.
Rhus :: A genus of shrubs and small treets. See Sumac.
Resolver :: "One who resolves  or formal a firm purpose."
Zincing :: The act or process of applying zinc; galvanization.
Fleered :: of Fleer
Hint :: "To make an indirect reference  suggestion  or allusion; to allude vaguely to something."
Hedgehog :: The Canadian porcupine.
Resultant :: That which results.
Revealing :: of Reveal
Scalado :: See Escalade.
Revert :: "To turn back  or to the contrary; to reverse."
Salutatory :: "Containing or expressing salutations; speaking a welcome; greeting; -- applied especi
Rebloom :: To bloom again.
Rundel :: A circle.
Uplock :: To lock up.
Alkarsin :: "A spontaneously inflammable liquid  having a repulsive odor  and consisting of cacodyl 
Horse :: A breastband for a leadsman.
Tag :: "To fit with  or as with  a tag or tags."
Unsitting :: Not sitting well; unbecoming.
Fructify :: To bear fruit.
Fornix :: "Esp.  two longitudinal bands of white nervous tissue beneath the lateral ventricles of th
Saxon :: Also used in the sense of Anglo-Saxon.
Naperian :: "Of  pertaining to  or discovered by  Napier  or Naper."
Rare :: "Nearly raw; partially cooked; not thoroughly cooked; underdone; as  rare beef or mutton."
Taenioidea :: The division of cestode worms which comprises the tapeworms. See Tapeworm.
Aids-de-camp :: of Aid-de-camp
Gab :: To talk idly; to prate; to chatter.
Scantling :: A fragment; a bit; a little piece.
Legal :: "Created by  permitted by  in conformity with  or relating to  law; as  a legal obligation;
Headstone :: The principal stone in a foundation; the chief or corner stone.
Allegation :: "That which is alleged  asserted  or declared; positive assertion; formal averment"
Accuser :: One who accuses; one who brings a charge of crime or fault.
Roseo- :: A prefix (also used adjectively) signifying rose-red; specifically used to designate certa
Jointer :: A plane for smoothing the surfaces of pieces which are to be accurately joined
Have :: "To bear  as young; as  she has just had a child."
Jawbone :: The bone of either jaw; a maxilla or a mandible.
Gull :: To deceive; to cheat; to mislead; to trick; to defraud.
Gnome :: A brief reflection or maxim.
Gothicize :: To make Gothic; to bring back to barbarism.
Warm :: "Violent; vehement; furious; excited; passionate; as  a warm contest; a warm debate."
Hurricanoes :: of Hurricano
Salamstone :: A kind of blue sapphire brought from Ceylon.
Rose :: "A perforated nozzle  as of a pipe  spout  etc.  for delivering water in fine jets; a rosehe
Fausse-braye :: "A second raampart  exterior to  and parallel to  the main rampart  and considerably
Round :: "Uttered or emitted with a full tone; as  a round voice; a round note."
War :: To contend; to strive violently; to fight.
Ginglyform :: Ginglymoid.
Wappet :: A small yelping cur.
Houris :: of Houri
Repeller :: "One who  or that which  repels."
Alunite :: Alum stone.
Scaphocephaly :: "A deformed condition of the skull  in which the vault is narrow  elongated  and mo
Fuzz :: "Fine  light particles or fibers; loose  volatile matter."
Verso :: "The reverse  or left-hand  page of a book or a folded sheet of paper; -- opposed to recto.
Holiday :: A day of exemption from labor; a day of amusement and gayety; a festival day.
Flux :: "Any substance or mixture used to promote the fusion of metals or minerals  as alkalies  bor
Rangement :: Arrangement.
Earing :: "Coming into ear  as corn."
Scrimshaw :: "To ornament  as shells  ivory  etc.  by engraving  and (usually) rubbing pigments into
Adjunct :: Conjoined; attending; consequent.
Saw :: "An instrument for cutting or dividing substances  as wood  iron  etc.  consisting of a thin 
Heald :: A heddle.
Backing :: Support or aid given to a person or cause.
Night :: Darkness; obscurity; concealment.
Rhymer :: One who makes rhymes; a versifier; -- generally in contempt; a poor poet; a poetaster.
Went :: of Go
Foresee :: To have or exercise foresight.
Rhodocrinite :: A rose encrinite.
Glutinous :: Of the nature of glue; resembling glue; viscous; viscid; adhesive; gluey.
Funguses :: of Fungus
Gallicizing :: of Gallicize
Remain :: That which is left; relic; remainder; -- chiefly in the plural.
Houri :: A nymph of paradise; -- so called by the Mohammedans.
Justification :: "The act of justifying or the state of being justified; a showing or proving to be 
Ladde :: "of Lead  to guide."
Utmost :: "The most that can be; the farthest limit; the greatest power  degree  or effort; as  he h
Acaudate :: Tailless.
Salve :: "To heal by applications or medicaments; to cure by remedial treatment; to apply salve to; 
Waking :: of Wake
Hygrophanous :: "Having such a structure as to be diaphanous when moist  and opaque when dry."
Ablation :: Extirpation.
Forced :: of Force
Realm :: A royal jurisdiction or domain; a region which is under the dominion of a king; a kingdom.
Yelper :: The tattler.
Ferroprussic :: Ferrocyanic.
Alpen :: Of or pertaining to the Alps.
Cadge :: "To hawk or peddle  as fish  poultry  etc."
Allowance :: Approval; approbation.
Pains :: "Labor; toilsome effort; care or trouble taken; -- plural in form  but used with a singular
Unroost :: To drive from the roost.
Hippopotamuses :: of Hippopotamus
Adjudicator :: One who adjudicates.
Jo :: A sweetheart; a darling.
Responsory :: "A versicle sung in answer to the priest  or as a refrain."
Kercher :: A kerchief.
Rubied :: of Ruby
Scandalize :: "To offend the feelings or the conscience of (a person) by some action which is consid
Babehood :: Babyhood.
Air :: The representation or reproduction of the effect of the atmospheric medium through which ever
Haggard :: A stackyard.
Fleecer :: "One who fleeces or strips unjustly  especially by trickery or fraund."
Gather :: To grow larger by accretion; to increase.
Undoubtable :: Indubitable.
Kayaker :: One who uses a kayak.
Footfight :: A conflict by persons on foot; -- distinguished from a fight on horseback.
Read :: "To perform the act of reading; to peruse  or to go over and utter aloud  the words of a boo
Free will :: The power asserted of moral beings of willing or choosing without the restraints of phy
Flavorles :: Without flavor; tasteless.
Unbereaven :: Unbereft.
House :: "To take or put into a house; to shelter under a roof; to cover from the inclemencies of th
Hemstitching :: of Hemstitch
Lade :: "To admit water by leakage  as a ship  etc."
Jobber :: "One who buys goods from importers  wholesalers  or manufacturers  and sells to retailers.
Gluttony :: Excess in eating; extravagant indulgence of the appetite for food; voracity.
Godliness :: "Careful observance of  or conformity to  the laws of God; the state or quality of bein
Redthroat :: "A small Australian singing bird (Phyrrholaemus brunneus). The upper parts are brown  t
Glycosuria :: Same as Glucosuria.
Hunger :: To make hungry; to famish.
Rigorous :: "Manifesting  exercising  or favoring rigor; allowing no abatement or mitigation; scrupu
Noticeable :: Capable of being observed; worthy of notice; likely to attract observation; conspicous
Sarcobases :: of Sarcobasis
Sauvegarde :: The monitor.
Rentier :: "One who has a fixed income  as from lands  stocks  or the like."
Sankha :: "A chank shell (Turbinella pyrum); also  a shell bracelet or necklace made in India from t
Fluvial :: "Belonging to rivers; growing or living in streams or ponds; as  a fluvial plant."
Bacchanalia :: A feast or an orgy in honor of Bacchus.
Greith :: Goods; furniture.
Vaulting :: The act of constructing vaults; a vaulted construction.
Farding-bag :: "The upper stomach of a cow  or other ruminant animal; the rumen."
Laputan :: "Of or pertaining to Laputa  an imaginary flying island described in Gulliver's Travels a
Earldom :: The jurisdiction of an earl; the territorial possessions of an earl.
Hability :: Ability; aptitude.
Hyalescence :: "The process of becoming  or the state of being  transparent like glass."
Sabbath :: "Fig.: A time of rest or repose; intermission of pain  effort  sorrow  or the like."
Scene :: To exhibit as a scene; to make a scene of; to display.
Sea monster :: Any large sea animal.
Radiative :: Capable of radiating; acting by radiation.
Gtratuities :: of Gratuity
Earthpea :: "A species of pea (Amphicarpaea monoica). It is a climbing leguminous plant  with hairy 
Palmated :: "Having the distal portion broad  flat  and more or less divided into lobes; -- said of 
Zingari :: of Zingaro
Hindooism :: Alt. of Hinduism
Vena :: A vein.
Utis :: See Utas.
Grouting :: of Grout
Ligamental :: Alt. of Ligamentous
Freedom :: Privileges; franchises; immunities.
Neutrally :: In a neutral manner; without taking part with either side; indifferently.
After :: "According to; in accordance with; in conformity with the nature of; as  he acted after his
Fratricide :: The act of one who murders or kills his own brother.
Frittering :: of Fritter
Uniformitarian :: "One who accepts uniformitarianism  or the uniformitarian doctrine."
Palea :: The interior chaff or husk of grasses.
Furzen :: Furzy; gorsy.
Unfriendly :: "Not friendly; not kind or benevolent; hostile; as  an unfriendly neighbor."
Alevin :: Young fish; fry.
Northwestern :: "Of  pertaining to  or being in  the northwest; in a direction toward the northwest;
Handcraft :: Same as Handicraft.
Goblin :: An evil or mischievous spirit; a playful or malicious elf; a frightful phantom; a gnome.
Fumigate :: "To apply smoke to; to expose to smoke or vapor; to purify  or free from infection  by t
Sasin :: "The Indian antelope (Antilope bezoartica  / cervicapra)  noted for its beauty and swiftnes
Resist :: To be distasteful to.
Adding :: of Add
Lichenologist :: One versed in lichenology.
Nart :: Art not.
Pad :: "A kind of cushion for writing upon  or for blotting; esp.  one formed of many flat sheets of
Fowler's solution :: "An aqueous solution of arsenite of potassium  of such strength that one hundre
Histories :: of History
Remorseful :: Compassionate; feeling tenderly.
Saturated :: "Filled to repletion; holding by absorption  or in solution  all that is possible; as  
Nariform :: Formed like the nose.
Rivel :: "To contract into wrinkles; to shrivel; to shrink; as  riveled fruit; riveled flowers."
Felter :: To clot or mat together like felt.
Nubia :: "A light fabric of wool  worn on the head by women; a cloud."
Larynx :: "The expanded upper end of the windpipe or trachea  connected with the hyoid bone or carti
Herald :: Any messenger.
Raft :: of Reave
Hopeless :: "Giving no ground of hope; promising nothing desirable; desperate; as  a hopeless cause.
Frondescence :: The act of bursting into leaf.
Paddle :: "An implement with a broad blade  which is used without a fixed fulcrum in propelling and 
Hang :: "To hold for support; to depend; to cling; -- usually with on or upon; as  this question han
Variscite :: An apple-green mineral occurring in reniform masses. It is a hydrous phosphate of alumi
Abate :: Abatement.
High-raised :: Elated with great ideas or hopes.
Greenish :: "Somewhat green; having a tinge of green; as  a greenish yellow."
Scholiums :: of Scholium
Raven :: Rapine; rapacity.
Acme :: The crisis or height of a disease.
Floriken :: An Indian bustard (Otis aurita). The Bengal floriken is Sypheotides Bengalensis.
Sciurine :: Of or pertaining to the Squirrel family.
Tackle :: "To seize; to lay hold of; to grapple; as  a wrestler tackles his antagonist; a dog tackle
Ubiety :: The quality or state of being in a place; local relation; position or location; whereness.
Horticulturist :: One who practices horticulture.
Screw :: "A straight line in space with which a definite linear magnitude termed the pitch is associ
Veto :: An authoritative prohibition or negative; a forbidding; an interdiction.
Vernation :: "The arrangement of the leaves within the leaf bud  as regards their folding  coiling  
Accessory :: "Anything that enters into a work of art without being indispensably necessary  as mere
Hospitable :: "Proceeding from or indicating kindness and generosity to guests and strangers; as  ho
Palampore :: See Palempore.
Fastness :: The state of being fast and firm; firmness; fixedness; security; faithfulness.
Heliography :: Photography.
Pack :: To unite in bad measures; to confederate for ill purposes; to join in collusion.
Niteosaccharin :: "An explosive nitro derivative of certain sugars  analogous to nitroglycerin  gun 
Unrioted :: Free from rioting.
Acquirable :: Capable of being acquired.
Regalia :: "A kind of cigar of large size and superior quality; also  the size in which such cigars 
Relinquishment :: The act of relinquishing.
Ravishment :: The act of ravishing a woman; rape.
Wage :: "To adventure  or lay out  for hire or reward; to hire out."
Gorget :: "A crescent-shaped  colored patch on the neck of a bird or mammal."
Gyreful :: Abounding in gyres.
Kettledrum :: "An informal social party at which a light collation is offered  held in the afternoon
Halt :: To have an irregular rhythm; to be defective.
Jut :: A shove; a push.
Leg :: The course and distance made by a vessel on one tack or between tacks.
Scopula :: A special tuft of hairs on the leg of a bee.
Unbar :: "To remove a bar or bars from; to unbolt; to open; as  to unbar a gate."
Admissibility :: "The quality of being admissible; admissibleness; as  the admissibility of evidence
Rabbinic :: The language or dialect of the rabbins; the later Hebrew.
Reception :: "The act of receiving; receipt; admission; as  the reception of food into the stomach; 
Scelet :: A mummy; a skeleton.
Negotiosity :: The state of being busy; multitude of business.
Saurognathous :: "Having the bones of the palate arranged as in saurians  the vomer consisting of tw
Callose :: Furnished with protuberant or hardened spots.
Unking :: To cause to cease to be a king.
Nicknackery :: See Knickknackery.
Unarm :: "To puff off  or lay down  one's arms or armor."
Nourisher :: "One who  or that which  nourishes."
Great :: "Entitled to earnest consideration; weighty; important; as  a great argument  truth  or pri
Green :: "Full of life aud vigor; fresh and vigorous; new; recent; as  a green manhood; a green woun
Guelph :: Alt. of Guelf
Salmi :: Same as Salmis.
Tabooing :: of Taboo
Fellowship :: The state or relation of being or associate.
Furacity :: Addictedness to theft; thievishness.
Forth :: "Out  as from a state of concealment  retirement  confinement  nondevelopment  or the like;
Feofor :: Alt. of Feoffer
Agate :: A diminutive person; so called in allusion to the small figures cut in agate for rings and 
Horopter :: "The line or surface in which are situated all the points which are seen single while th
Gest :: A guest.
Fastilarian :: A low fellow; a stinkard; a scoundrel.
Reoppose :: To oppose again.
Babel :: "The city and tower in the land of Shinar  where the confusion of languages took place."
School :: "A shoal; a multitude; as  a school of fish."
Yarnut :: See Yernut.
Fig :: A small piece of tobacco.
Gour :: See Koulan.
Roughcast :: "To plaster with a mixture of lime and shells or pebbles; as  to roughcast a building."
Scrip :: Paper fractional currency.
Needy :: Necessary; requiste.
Jade :: "A stone  commonly of a pale to dark green color but sometimes whitish. It is very hard and 
Afoot :: On foot.
Urethritis :: Inflammation of the urethra.
Flatboat :: "A boat with a flat bottom and square ends; -- used for the transportation of bulky frei
Ligate :: To tie with a ligature; to bind around; to bandage.
Keelson :: "A piece of timber in a ship laid on the middle of the floor timbers over the keel  and b
Rind :: To remove the rind of; to bark.
Gull :: A cheating or cheat; trick; fraud.
Guebre :: Same as Gheber.
Kathetal :: "Making a right angle; perpendicular  as two lines or two sides of a triangle  which inc
Honor :: "A nice sense of what is right  just  and true  with course of life correspondent thereto; 
Hadji :: A Mohammedan pilgrim to Mecca; -- used among Orientals as a respectful salutation or a titl
Kill :: "A channel or arm of the sea; a river; a stream; as  the channel between Staten Island and B
Fashion :: To forge or counterfeit.
Xiphisternum :: "The posterior segment  or extremity  of the sternum; -- sometimes called metasternu
Fibrillary :: Of of pertaining to fibrils.
Galaxy :: "The Milky Way; that luminous tract  or belt  which is seen at night stretching across the
Fornix :: "An arch or fold; as  the fornix  or vault  of the cranium; the fornix  or reflection  of 
Alcoholometer :: Alt. of Alcoholmeter
Hutch :: "To hoard or lay up  in a chest."
Aeolotropy :: Difference of quality or property in different directions.
Unsling :: "To take off the slings of  as a yard  a cask  or the like; to release from the slings."
Folder :: "One who  or that which  folds; esp.  a flat  knifelike instrument used for folding paper.
Watchman :: One set to watch; a person who keeps guard; a guard; a sentinel.
Scene :: "An exhibition of passionate or strong feeling before others; often  an artifical or affect
Four-cornered :: Having four corners or angles.
Range :: A wandering or roving; a going to and fro; an excursion; a ramble; an expedition.
Ear :: Same as Crossette.
Gladiole :: "A lilylike plant  of the genus Gladiolus; -- called also corn flag."
Reward :: "That which is given in return for good or evil done or received; esp.  that which is offe
Rotula :: "The patella  or kneepan."
Yielding :: "Inclined to give way  or comply; flexible; compliant; accommodating; as  a yielding tem
After-mentioned :: "Mentioned afterwards; as  persons after-mentioned (in a writing)."
Nauseative :: Causing nausea; nauseous.
Fromwards :: A way from; -- the contrary of toward.
Tack :: "To change the direction of (a vessel) when sailing closehauled  by putting the helm alee an
Finicky :: Finical; unduly particular.
Guerdon :: A reward; requital; recompense;  -- used in both a good and a bad sense.
Ramadan :: The ninth Mohammedan month.
Wake :: To rouse from sleep; to awake.
Wanhope :: "Want of hope; despair; also  faint or delusive hope; delusion. [Obs.] Piers Plowman."
Learned :: "Of or pertaining to learning; possessing  or characterized by  learning  esp. scholastic
Zeroes :: of Zero
Forebear :: An ancestor. See Forbear.
Length :: "A single piece or subdivision of a series  or of a number of long pieces which may be con
Alexipyretic :: Serving to drive off fever; antifebrile.
Ibis :: "Any bird of the genus Ibis and several allied genera  of the family Ibidae  inhabiting both
Generation :: Race; kind; family; breed; stock.
Fondler :: One who fondles.
Giddy :: To reel; to whirl.
Notch :: "A narrow passage between two elevation; a deep  close pass; a defile; as  the notch of a m
Hobbism :: "The philosophical system of Thomas Hobbes  an English materialist (1588-1679); esp.  his
Fume :: "Rage or excitement which deprives the mind of self-control; as  the fumes of passion."
Kidnap :: "To take (any one) by force or fear  and against one's will  with intent to carry to anoth
Backing :: "The act of moving backward  or of putting or moving anything backward."
Sea butterfly :: A pteropod.
Upset :: "To shorten (a tire) in the process of resetting  originally by cutting it and hammering on
Glyoxal :: "A white  amorphous  deliquescent powder  (CO.H)2  obtained by the partial oxidation of g
Horn :: "The outer end of a crosstree; also  one of the projections forming the jaws of a gaff  boom
Eblanin :: See Pyroxanthin.
Variance :: Difference that produce dispute or controversy; disagreement; dissension; discord; dispu
Fourneau :: The chamber of a mine in which the powder is placed.
Painless :: Free from pain; without pain.
Reason :: "To find by logical processes; to explain or justify by reason or argument; -- usually wit
Radical :: Of or pertaining to the root; proceeding directly from the root.
Repeater :: A repeating firearm.
Ulna :: "The postaxial bone of the forearm  or branchium  corresponding to the fibula of the hind li
Haemomanometer :: Same as Hemadynamometer.
Tail :: "Any long  flexible terminal appendage; whatever resembles  in shape or position  the tail o
Venerating :: of Venerate
Fanned :: of Fan
Labeling :: of Label
Nephoscope :: An instrument for observing the clouds and their velocity.
Gypsoplast :: "A cast taken in plaster of Paris  or in white lime."
Garnet :: A tackle for hoisting cargo in our out.
Umbellated :: "Bearing umbels; pertaining to an umbel; umbel-like; as  umbellate plants or flowers."
Rot :: Figuratively: To perish slowly; to decay; to die; to become corrupt.
Eavesdrop :: The water which falls in drops from the eaves of a house.
Acquitment :: Acquittal.
Unilabiate :: "Having one lip only; as  a unilabiate corolla."
Feat :: "A striking act of strength  skill  or cunning; a trick; as  feats of horsemanship  or of de
Functionalize :: To assign to some function or office.
Againbuy :: To redeem.
Badger :: "A carnivorous quadruped of the genus Meles or of an allied genus.  It is a burrowing anim
Ruche :: "A plaited  quilled  or goffered strip of lace  net  ribbon  or other material  -- used in 
Sacrarium :: "A sort of family chapel in the houses of the Romans  devoted to a special divinity."
Riser :: "Any small upright face  as of a seat  platform  veranda  or the like."
Ulcered :: Ulcerous; ulcerated.
Horseknop :: Knapweed.
Victim :: "Hence  one who is duped  or cheated; a dupe; a gull."
Lady's laces :: A slender climbing plant; dodder.
Geodesic :: A geodetic line or curve.
Glave :: See Glaive.
Hardly :: Severely; harshly; roughly.
Fuzz :: To fly off in minute particles.
Judaization :: The act of Judaizing; a conforming to the Jewish religion or ritual.
Falsify :: To tell lies; to violate the truth.
Active :: Applied to all verbs that express action as distinct from mere existence or state.
Radde :: "imp. of Read  Rede."
Franklinite :: A kind of mineral of the spinel group.
Nother :: Neither; nor.
Noneffective :: Not effective.
Macrophyllous :: Having long or large leaves.
Ungulate :: Any hoofed quadruped; one of the Ungulata.
High-flown :: Elevated; proud.
Riband :: See Rib-band.
Run :: State of being current; currency; popularity.
Flax-plant :: "A plant in new Zealand (Phormium tenax)  allied to the lilies and aloes. The leaves a
Now :: Existing at the present time; present.
Norma :: A norm; a principle or rule; a model; a standard.
Labiated :: "Same as Labiate  a. (a)."
Aggrate :: To please.
Earthborn :: "Relating to  or occasioned by  earthly objects."
Hard-shell :: Unyielding; insensible to argument; uncompromising; strict.
Resinous :: Of or pertaining to resin; of the nature of resin; resembling or obtained from resin.
Nonplussing :: of Nonplus
Sconce :: To mulct; to fine.
Fathering :: of Father
Retainable :: Capable of being retained.
Flowk :: See 1st Fluke.
Agglutinate :: "To unite  or cause to adhere  as with glue or other viscous substance; to unite by c
Girrock :: A garfish.
Hawaiian :: "Belonging to Hawaii or the Sandwich Islands  or to the people of Hawaii."
Cabin :: "To live in  or as in  a cabin; to lodge."
Unexpressible :: Inexpressible.
Macrocephalous :: Having a large head.
Homacanth :: "Having the dorsal fin spines symmetrical  and in the same line; -- said of certain fis
Hypothecating :: of Hypothecate
Ray :: "To shine  as with rays."
Scandalized :: of Scandalize
Karma :: One's acts considered as fixing one's lot in the future existence. (Theos.) The doctrine of
Acrotic :: Pertaining to or affecting the surface.
Ragged :: "Rent or worn into tatters  or till the texture is broken; as  a ragged coat; a ragged sai
Scraping :: "Resembling the act of  or the effect produced by  one who  or that which  scrapes; as  
Row :: Rough; stern; angry.
Aguardiente :: A inferior brandy of Spain and Portugal.
Nainsook :: "A thick sort of jaconet muslin  plain or striped  formerly made in India."
Haply :: "By hap  chance  luck  or accident; perhaps; it may be."
Graduate :: "To taper  as the tail of certain birds."
Ridgy :: Having a ridge or ridges; rising in a ridge.
Tabby :: An old maid or gossip.
Salite :: To season with salt; to salt.
Necromancy :: "The art of revealing future events by means of a pretended communication with the dea
Harikari :: See Hara-kiri.
Retrait :: A portrait; a likeness.
Regelation :: "The act or process of freezing anew  or together as two pieces of ice."
Unreverence :: Absence or lack of reverence; irreverence.
Frigorifical :: Causing cold; producing or generating cold.
Valetudinary :: Infirm; sickly; valetudinarian.
Hurrah :: "A cheer; a shout of joy  etc."
Father :: "A dignitary of the church  a superior of a convent  a confessor (called also father confe
Floridly :: In a florid manner.
Obelizing :: of Obelize
Revolutionist :: One engaged in effecting a change of government; a favorer of revolution.
Gaggle :: A flock of wild geese.
Flush :: A hand of cards of the same suit.
Junior :: "Composed of juniors  whether younger or a lower standing; as  the junior class; of or per
Rigorous :: "Severe; intense; inclement; as  a rigorous winter."
Fit :: "Conformed to a standart of duty  properiety  or taste; convenient; meet; becoming; proper."
Rest :: "To stand firm; to be fixed; to be supported; as  a column rests on its pedestal."
Hexachord :: "A series of six notes  with a semitone between the third and fourth  the other interva
Screenings :: "The refuse left after screening sand  coal  ashes  etc."
Flemish :: "The language or dialect spoken by the Flemings; also  collectively  the people of Flande
Neutral :: Neither good nor bad; of medium quality; middling; not decided or pronounced.
Responsibility :: "The state of being responsible  accountable  or answerable  as for a trust  debt 
Acturience :: Tendency or impulse to act.
Flyspeck :: "A speck or stain made by the excrement of a fly; hence  any insignificant dot."
Habitator :: A dweller; an inhabitant.
Echoscope :: An instrument for intensifying sounds produced by percussion of the thorax.
Calcification :: "The process of change into a stony or calcareous substance by the deposition of li
Vesicate :: To raise little bladders or blisters upon; to inflame and separate the cuticle of; to bl
Unific :: Making one or unity; unifying.
Find :: "Anything found; a discovery of anything valuable; especially  a deposit  discovered by arch
Ague :: "An intermittent fever  attended by alternate cold and hot fits."
Vagabond :: "One who wanders from place to place  having no fixed dwelling  or not abiding in it  an
Furcular :: Shaped like a fork; furcate.
Accuse :: To betray; to show. [L.]
Jolliness :: Jollity; noisy mirth.
Talaria :: "Small wings or winged shoes represented as fastened to the ankles  -- chiefly used as an
Sax-tuba :: "A powerful instrument of brass  curved somewhat like the Roman buccina  or tuba."
Utilitarian :: One who holds the doctrine of utilitarianism.
Kernelled :: Having a kernel.
Caen stone :: "A cream-colored limestone for building  found near Caen  France."
Kedge :: "To move (a vessel) by carrying out a kedge in a boat  dropping it overboard  and hauling t
Rib :: One of the curved bones attached to the vertebral column and supporting the lateral walls of 
Harns :: The brains.
Aero- :: The combining form of the Greek word meaning air.
Xenodochium :: A house for the reception of strangers.
Laborious :: "Requiring labor  perseverance  or sacrifices; toilsome; tiresome."
Acanthopterygii :: "An order of fishes having some of the rays of the dorsal  ventral  and anal fins
Homaxonial :: "Relating to that kind of homology or symmetry  the mathematical conception of organic
Retrospect :: "To look backward; hence  to affect or concern what is past."
neatness :: The state or quality of being neat.
Hemipterous :: Of or pertaining to the Hemiptera.
Yeve :: To give.
Lay :: A wager.
Victualled :: of Victual
Freckle :: "A small yellowish or brownish spot in the skin  particularly on the face  neck  or hands
Rallying :: of Rally
Hurdle :: "An artificial barrier  variously constructed  over which men or horses leap in a race."
Reembrace :: To embrace again.
Eaglet :: "A young eagle  or a diminutive eagle."
Nationalize :: "To make national; to make a nation of; to endow with the character and habits of a n
Highty-tighty :: Hoity-toity.
Hemimorphic :: Having the two ends modified with unlike planes; -- said of a crystal.
Seamed :: Out of condition; not in good condition; -- said of a hawk.
Rail :: "A bar of steel or iron  forming part of the track on which the wheels roll. It is usually s
Lash :: "A leash in which an animal is caught or held; hence  a snare."
Neighborliness :: The quality or state of being neighborly.
Fig :: Figure; dress; array.
Scorse :: To chase.
Foredoom :: To doom beforehand; to predestinate.
Half-fish :: A salmon in its fifth year of growth.
Hyrse :: Millet.
Resurrection :: State of being risen from the dead; future state.
Nerve :: "One of the nervures  or veins  in the wings of insects."
Easterly :: "Situated  directed  or moving toward the east; as  the easterly side of a lake; an east
Fresh :: "Renewed in vigor  alacrity  or readiness for action; as  fresh for a combat; hence  tendin
Homogeneous :: "Of the same kind of nature; consisting of similar parts  or of elements of the like 
Accombination :: A combining together.
Need :: A state that requires supply or relief; pressing occasion for something; necessity; urgent w
Unheard :: "Not heard; not perceived by the ear; as  words unheard by those present."
Raging :: of Rage
Humble :: "Thinking lowly of one's self; claiming little for one's self; not proud  arrogant  or ass
Nero :: "A Roman emperor notorius for debauchery and barbarous cruelty; hence  any profligate and cr
Backwater :: "Water thrown back by the turning of a waterwheel  or by the paddle wheels of a steamer
Hairpin :: "A pin  usually forked  or of bent wire  for fastening the hair in place  -- used by wome
Saddle-backed :: "Having a low back and high neck  as a horse."
Gut :: "A narrow passage of water; as  the Gut of Canso."
Galley :: A proof sheet taken from type while on a galley; a galley proof.
Cabbage :: Cloth or clippings cabbaged or purloined by one who cuts out garments.
Revelled :: of Revel
Fleetingly :: In a fleeting manner; swiftly.
Acetamide :: "A white crystalline solid  from ammonia by replacement of an equivalent of hydrogen by
Unowned :: Not acknowledged; not avowed.
Harmonics :: The doctrine or science of musical sounds.
House :: To drive to a shelter.
Gobline :: One of the ropes or chains serving as stays for the dolphin striker or the bowsprit; -- c
Horse power :: "A unit of power  used in stating the power required to drive machinery  and in estim
Waistcoat :: "A short  sleeveless coat or garment for men  worn under the coat  extending no lower t
Valsalvian :: "Of or pertaining to Valsalva  an Italian anatomist of the 17th century."
-less :: "A privative adjective suffix  denoting without  destitute of  not having; as witless  chil
Upspring :: To spring up.
Gutta :: A drop.
Homeopathic :: Of or pertaining to homeopathy; according to the principles of homeopathy.
Glorified :: of Glorify
Fieldy :: "Open  like a field."
Forsay :: To forbid; to renounce; to forsake; to deny.
Laundrymen :: of Laundryman
Rattled :: of Rattle
Ferrara :: A sword bearing the mark of one of the Ferrara family of Italy. These swords were highly 
Vermily :: Vermeil.
Macaroni :: A medley; something droll or extravagant.
Fingering :: of Finger
Water god :: "A fabulous deity supposed to dwell in  and preside over  some body of water."
Retrofract :: Alt. of Retrofracted
Journalizing :: of Journalize
Ado :: "Doing; trouble; difficulty; troublesome business; fuss; bustle; as  to make a great ado abou
All Saints :: Alt. of All Saints'
Haematocrya :: The cold-blooded vertebrates. Same as Hematocrya.
Urgently :: In an urgent manner.
Goody :: An American fish; the lafayette or spot.
Hollo :: "Ho there; stop; attend; hence  a loud cry or a call to attract attention; a halloo."
Hand staves :: of Hand
Undernom :: of Undernime
Calling :: "A summoning or convocation  as of Parliament."
According :: of Accord
Resigner :: One who resigns.
Fictive :: Feigned; counterfeit.
Scoop :: "A spoon-shaped instrument  used in extracting certain substances or foreign bodies."
Rasores :: An order of birds; the Gallinae.
Level :: "Figuratively  to bring to a common level or plane  in respect of rank  condition  characte
Hyperbolize :: To speak or write with exaggeration.
Herb-women :: of Herb-woman
Rh/tizite :: A variety of the mineral cyanite.
Harmonist :: One who understands the principles of harmony or is skillful in applying them in compos
Veterinarian :: One skilled in the diseases of cattle or domestic animals; a veterinary surgeon.
Rigadoon :: "A gay  lively dance for one couple  -- said to have been borrowed from Provence in Fran
Humanics :: The study of human nature.
Halter-sack :: "A term of reproach  implying that one is fit to be hanged."
Addition :: The act of adding two or more things together; -- opposed to subtraction or diminution.
Hermeneutics :: "The science of interpretation and explanation; exegesis; esp.  that branch of theol
Latticed :: of Lattice
Foil :: "A blunt weapon used in fencing  resembling a smallsword in the main  but usually lighter an
Heben :: Ebony.
Father :: "The Supreme Being and Creator; God; in theology  the first person in the Trinity."
Ycleped :: "Called; named; -- obsolete  except in archaic or humorous writings."
Lamb :: "A simple  unsophisticated person; in the cant of the Stock Exchange  one who ignorantly spe
Represent :: To present again or anew; to present by means of something standing in the place of; to
Cagit :: "A kind of parrot  of a beautiful green color  found in the Philippine Islands."
Valedictory :: "A valedictory oration or address spoken at commencement in American colleges or semi
Nominator :: One who nominates.
Abalienate :: To cause alienation of (mind).
Gowany :: "Having  abounding in  or decked with  daisies."
Lepidolite :: "A species of mica  of a lilac or rose-violet color  containing lithia. It usually occ
Rattle :: A scolding; a sharp rebuke.
Hokeday :: Same as Hockday.
Father :: "One who  or that which  gives origin; an originator; a producer  author  or contriver; th
Santoninate :: A salt of santoninic acid.
Hyperion :: "The god of the sun; in the later mythology identified with Apollo  and distinguished fo
Huchen :: "A large salmon (Salmo  / Salvelinus  hucho) inhabiting the Danube; -- called also huso  a
Afresh :: Anew; again; once more; newly.
Gammon :: "To beat in the game of backgammon  before an antagonist has been able to get his ""men"" 
Finos :: Second best wool from Merino sheep.
Higre :: See Eagre.
Fay :: "To fit; to join; to unite closely  as two pieces of wood  so as to make the surface fit toge
Fauchion :: See Falchion.
Abortion :: The immature product of an untimely birth.
Realty :: Real estate; a piece of real property.
Accessary :: "One who  not being present  contributes as an assistant or instigator to the commissio
Made :: imp. &amp; p. p. of Make.
Grind :: To perform the operation of grinding something; to turn the millstones.
Untraveled :: "Having never visited foreign countries; not having gained knowledge or experience by 
Ulcuscule :: A little ulcer.
Keloid :: "Applied to a variety of tumor forming hard  flat  irregular excrescences upon the skin."
Unacquainted :: Not usual; unfamiliar; strange.
Flayed :: of Flay
Rigarion :: See Irrigation.
Holo- :: "A combining form fr. Gr. ""o`los whole."
Nisey :: A simpleton.
Faucal :: "Pertaining to the fauces  or opening of the throat; faucial; esp.  (Phon.) produced in th
Lathed :: of Lath
Fail :: To err in judgment; to be mistaken.
Faytour :: See Faitour.
Fytte :: See Fit a song.</BODY></HTML>
Macle :: Chiastolite; -- so called from the tessellated appearance of a cross section. See Chiastoli
Scanty :: Wanting amplitude or extent; narrow; small; not abundant.
Fabric :: The act of constructing; construction.
Keeper :: One who remains or keeps in a place or position.
Just :: "Barely; merely; scarcely; only; by a very small space or time; as  he just missed the train
Ziphioid :: See Xiphioid.
Resigned :: of Resign
Aeneous :: Colored like bronze.
Affectation :: An attempt to assume or exhibit what is not natural or real; false display; artificia
Lainere :: See Lanier.
Aidant :: Helping; helpful; supplying aid.
Water crane :: "A goose-neck apparatus for supplying water from an elevated tank  as to the tender o
Verify :: To make into a verb; to use as a verb; to verbalize.
Wag :: "To move one way and the other with quick turns; to shake to and fro; to move vibratingly; to
Sanguineous :: Blood-red; crimson.
Jairou :: The ahu or Asiatic gazelle.
Liberty :: Leave of absence; permission to go on shore.
Flat :: "A flat-bottomed boat  without keel  and of small draught."
Adulatress :: A woman who flatters with servility.
Homelike :: Like a home; comfortable; cheerful; cozy; friendly.
Underpight :: imp. of Underpitch.
Along :: In company; together.
Flood :: "The flowing in of the tide; the semidiurnal swell or rise of water in the ocean; -- oppose
Restriction :: "The act of restricting  or state of being restricted; confinement within limits or b
Ventriloquist :: "One who practices  or is skilled in  ventriloquism."
Guzzle :: An insatiable thing or person.
Groan :: "To give forth a low  moaning sound in breathing; to utter a groan  as in pain  in sorrow  
Scauper :: "A tool with a semicircular edge  -- used by engravers to clear away the spaces between t
Function :: Alt. of Functionate
Lengthen :: "To extent in length; to make longer in extent or duration; as  to lengthen a line or a 
Under-garment :: A garment worn below another.
Recommendation :: "That which recommends  or commends to favor; anything procuring  or tending to pr
Jargon :: "Confused  unintelligible language; gibberish; hence  an artificial idiom or dialect; cant
Seaboat :: "A boat or vessel adapted to the open sea; hence  a vessel considered with reference to h
Roomless :: Being without room or rooms.
Hobbyhorsical :: "Pertaining to  or having  a hobby or whim; eccentric; whimsical."
Fetishism :: The doctrine or practice of belief in fetiches.
Cabbage :: "The terminal bud of certain palm trees  used  like  cabbage  for food. See Cabbage tree 
Acknowledge :: "To own as genuine; to assent to  as a legal instrument  to give it validity; to avow
Favella :: "A group of spores arranged without order and covered with a thin gelatinous envelope  as
Sea cock :: "A gurnard  as the European red gurnard (Trigla pini)."
Run :: "The greatest degree of swiftness in marching.  It is executed upon the same principles as th
Heroic :: "Of or pertaining to  or like  a hero; of the nature of heroes; distinguished by the exist
Recognizability :: The quality or condition of being recognizable.
Ropedancer :: "One who dances  walks  or performs acrobatic feats  on a rope extended through the ai
Understrapping :: Becoming an understrapper; subservient.
Adulteress :: A woman who commits adultery.
Flit :: To flutter; to rove on the wing.
Fifteenth :: "A species of tax upon personal property formerly laid on towns  boroughs  etc.  in Eng
Urite :: One of the segments of the abdomen or post-abdomen of arthropods.
Houseless :: "Destitute of the shelter of a house; shelterless; homeless; as  a houseless wanderer."
Neurotic :: "Of or pertaining to the nerves; seated in the nerves; nervous; as  a neurotic disease."
Headdress :: "A manner of dressing the hair or of adorning it  whether with or without a veil  ribbo
Forwardness :: "An advanced stage of progress or of preparation; advancement; as  his measures were 
Hope :: "A desire of some good  accompanied with an expectation of obtaining it  or a belief that it
Gluteal :: "Pertaining to  or in the region of  the glutaeus."
Heterodromous :: "Moving in opposite directions; -- said of a lever  pulley  etc.  in which the resi
Recognize :: "To avow knowledge of; to allow that one knows; to consent to admit  hold  or the like;
Schade :: Shade; shadow.
Redan :: A work having two parapets whose faces unite so as to form a salient angle toward the enemy
Faecal :: See Fecal.
Scleriasis :: A morbid induration of the edge of the eyelid.
Hang :: "To cover  decorate  or furnish by hanging pictures trophies  drapery  and the like  or by c
Judaizer :: "One who conforms to or inculcates Judaism; specifically  pl. (Ch. Hist.)  those Jews wh
Roosa oil :: The East Indian name for grass oil. See under Grass.
Roulette :: "the curve traced by any point in the plane of a given curve when the latter rolls  with
Umbo :: "A boss  or rounded elevation  or a corresponding depression  in a palate  disk  or membrane
Scug :: To hide.
Gadding :: of Gad
Honor :: "Academic or university prizes or distinctions; as  honors in classics."
Land :: "To set down after conveying; to cause to fall  alight  or reach; to bring to the end of a c
Hoof :: See Ungula.
Flour :: "To grind and bolt; to convert into flour; as  to flour wheat."
Heuristic :: Serving to discover or find out.
Verd :: Greenness; freshness.
Necessity :: "The quality or state of being necessary  unavoidable  or absolutely requisite; inevita
Allision :: "The act of dashing against  or striking upon."
Nationalizing :: of Nationalize
Adherent :: That which adheres; an appendage.
Glase :: "To apply thinly a transparent or semitransparent color to (another color)  to modify the e
Flax :: "A plant of the genus Linum  esp. the L. usitatissimum  which has a single  slender stalk  a
Pad :: "A measure for fish; as  sixty mackerel go to a pad; a basket of soles."
Water rat :: The muskrat.
Use :: "The special form of ritual adopted for use in any diocese; as  the Sarum  or Canterbury  use
Vacant :: "Abandoned; having no heir  possessor  claimant  or occupier; as  a vacant estate."
Hypostatical :: "Depending upon  or due to  deposition or setting; as  hypostatic cognestion  cognes
Laryngotracheal :: "Pertaining to both larynx and trachea; as  the laryngotracheal cartilage in the 
Refining :: of Refine
Light :: "White or whitish; not intense or very marked; not of a deep shade; moderately colored; as 
Agora :: "An assembly; hence  the place of assembly  especially the market place  in an ancient Gree
Scaturient :: Gushing forth; full to overflowing; effusive.
Harrier :: One who harries.
Rechoose :: To choose again.
Act :: A state of reality or real existence as opposed to a possibility or possible existence.
Lackey :: To act or serve as lackey; to pay servile attendance.
Salimetry :: The art or process of measuring the amount of salt in a substance.
Garggled :: of Gargle
Reattachment :: The act of reattaching; a second attachment.
Houseleek :: "A succulent plant of the genus Sempervivum (S. tectorum)  originally a native of subal
Fawn :: Of the color of a fawn; fawn-colored.
Rochelime :: Lime in the lump after it is burned; quicklime.
Kidney :: A glandular organ which excretes urea and other waste products from the animal body; a uri
Unrighteous :: "Not righteous; evil; wicked; sinful; as  an unrighteous man."
Jaunt :: A short excursion for pleasure or refreshment; a ramble; a short journey.
Tabular :: "Having a flat surface; as  a tabular rock."
Remonstrative :: Having the character of a remonstrance; expressing remonstrance.
Abolitionist :: "A person who favors the abolition of any institution  especially negro slavery."
Lenticulas :: of Lenticula
Sag :: State of sinking or bending; sagging.
Alias :: "Otherwise; otherwise called; -- a term used in legal proceedings to connect the different 
Salpas :: of Salpa
Hydrometeorological :: "Of or pertaining to hydrometeorology  or to rain  clouds  storms  etc."
Umbilical :: Pertaining to the center; central.
Formation :: "A group of beds of the same age or period; as  the Eocene formation."
Groggeries :: of Groggery
Hunt :: A district of country hunted over.
Rentered :: of Renter
Gobble :: To make a noise like that of a turkey cock.
Acclimatement :: Acclimation.
Removed :: of Remove
Accourage :: To encourage.
Foul :: "An entanglement; a collision  as in a boat race."
Revenue :: "That which returns  or comes back  from an investment; the annual rents  profits  intere
Accommodation :: "The application of a writer's language  on the ground of analogy  to something not
Runt :: "A variety of domestic pigeon  related to the barb and carrier."
Ward :: To be vigilant; to keep guard.
Rudimentary :: "Of or pertaining to rudiments; consisting in first principles; elementary; initial; 
Pail :: "A vessel of wood or tin  etc.  usually cylindrical and having a bail  -- used esp. for carr
Reng :: A rung or round of a ladder.
Recognize :: "To know again; to perceive the identity of  with a person or thing previously known; t
Frap :: "To brace by drawing together  as the cords of a drum."
Goatskin :: Made of the skin of a goat.
Active :: "In action; actually proceeding; working; in force; -- opposed to quiescent  dormant  or e
Underwriter :: "One who underwrites his name to the conditions of an insurance policy  especially of
Gentle :: "To make kind and docile  as a horse."
Upward :: The upper part; the top.
Raze :: To erase; to efface; to obliterate.
Unbending :: Unyielding in will; not subject to persuasion or influence; inflexible; resolute; -- ap
Novitious :: Newly invented; recent; new.
Adaptative :: Adaptive.
Japhetic :: "Pertaining to  or derived from  Japheth  one of the sons of Noah; as  Japhetic nations 
Friended :: Having friends;
Satiate :: To saturate.
Savor :: "Sense of smell; power to scent  or trace by scent."
Homopter :: One of the Homoptera.
Flexuose :: Flexuous.
Lettered :: of Letter
Ranunculi :: of Ranunculus
Roared :: of Roar
Kill :: A kiln.
Gossip :: To make merry.
Unmaiden :: To ravish; to deflower.
Actuation :: A bringing into action; movement.
Scholastical :: Scholastic.
Caisson :: "A water-tight box  of timber or iron within which work is carried on in building foundat
Repose :: A lying at rest; sleep; rest; quiet.
Palladium :: "Any statue of the goddess Pallas; esp.  the famous statue on the preservation of which
Negation :: "Description or definition by denial  exclusion  or exception; statement of what a thing
Unresisted :: Not resisted; unopposed.
Affording :: of Afford
Refer :: "To have relation or reference; to relate; to point; as  the figure refers to a footnote."
Verminous :: Tending to breed vermin; infested by vermin.
Folderol :: Nonsense.
Rigmarole :: Consisting of rigmarole; frovolous; nonsensical; foolish.
Hecatompedon :: "A name given to the old Parthenon at Athens  because measuring 100 Greek feet  prob
Waterage :: "Money paid for transportation of goods  etc.  by water."
Hydramine :: "One of a series of artificial  organic bases  usually produced as thick viscous liquid
Gizzard :: "The second  or true  muscular stomach of birds  in which the food is crushed and ground 
Yellowwort :: "A European yellow-flowered  gentianaceous (Chlora perfoliata). The whole plant is int
Uraninite :: "A mineral consisting chiefly of uranium oxide with some lead  thorium  etc.  occurring
Valance :: The drooping edging of the lid of a trunk. which covers the joint when the lid is closed.
Nemalite :: A fibrous variety of brucite.
Univalent :: "Having a valence of one; capable of combining with  or of being substituted for  one a
Sceptre :: "Hence  royal or imperial power or authority; sovereignty; as  to assume the scepter."
Jayhawker :: "A name given to a free-booting  unenlisted  armed man or guerrilla."
Taint :: A blemish on reputation; stain; spot; disgrace.
Farfetched :: Studiously sought; not easily or naturally deduced or introduced; forced; strained.
Lease :: "A demise or letting of lands  tenements  or hereditaments to another for life  for a term 
Back :: "To a former state  condition  or station; as  to go back to private life; to go back to bar
Hobby :: Alt. of Hobbyhorse
L :: "An extension at right angles to the length of a main building  giving to the ground plan a for
Sclavonic :: Same as Slavonic.
Roundhouse :: "A cabin or apartament on the after part of the quarter-deck  having the poop for its 
Griffin :: An Anglo-Indian name for a person just arrived from Europe.
Sasse :: "A sluice or lock  as in a river  to make it more navigable."
Hermitage :: The habitation of a hermit; a secluded residence.
Northeastward :: Alt. of Northeastwardly
Calculation :: An expectation based on circumstances.
Sea bean :: Same as Florida bean.
Wash :: A medical preparation in a liquid form for external application; a lotion.
Grave :: "To write or delineate on hard substances  by means of incised lines; to practice engraving
Heart :: "To form a compact center or heart; as  a hearting cabbage."
Gainer :: One who gains.
Uninterested :: "Not interested; not having any interest or property in; having nothing at stake; as
Flea :: "An insect belonging to the genus Pulex  of the order Aphaniptera. Fleas are destitute of wi
Flattering :: "That flatters (in the various senses of the verb); as  a flattering speech."
Founder :: To fail; to miscarry.
Macerate :: "To soften by steeping in a liquid  with or without heat; to wear away or separate the p
Vengeful :: Vindictive; retributive; revengeful.
Gnawing :: of Gnaw
Humorsome :: Jocose; witty; humorous.
Acadian :: "Of or pertaining to Acadie  or Nova Scotia."
Hart's-ear :: "An Asiatic species of Cacalia (C. Kleinia)  used medicinally in India."
Alegge :: To allay or alleviate; to lighten.
Nasalize :: "To render nasal  as sound; to insert a nasal or sound in."
Rheotome :: An instrument which periodically or otherwise interrupts an electric current.
Note :: A brief writing intended to assist the memory; a memorandum; a minute.
Hood :: "A like appendage to a cloak or loose overcoat  that may be drawn up over the head at pleasu
Raconteur :: A relater; a storyteller.
Uintatherium :: An extinct genus of large Eocene ungulates allied to Dinoceras. This name is sometim
Accoutred :: of Accoutre
Scrimp :: "To make too small or short; to limit or straiten; to put on short allowance; to scant; to
Palea :: "A pendulous process of the skin on the throat of a bird  as in the turkey; a dewlap."
Hatchure :: Same as Hachure.
Jack :: "A bar of iron athwart ships at a topgallant masthead  to support a royal mast  and give spr
Haze :: "To harass by exacting unnecessary  disagreeable  or difficult work."
'Neath :: An abbreviation of Beneath.
Frizzly :: Alt. of Frizzy
Goldsmith :: A banker.
Saddlery :: The materials for making saddles and harnesses; the articles usually offered for sale in
Allow :: "To own or acknowledge; to accept as true; to concede; to accede to an opinion; as  to allo
Heating :: of Heat
Sea king :: One of the leaders among the Norsemen who passed their lives in roving the seas in searc
Pallium :: "A large  square  woolen cloak which enveloped the whole person  worn by the Greeks and b
Reverberatory :: A reverberatory furnace.
Gherkin :: See Sea gherkin.
Saddle-shaped :: Shaped like a saddle.
Water back :: See under 1st Back.
Rudder :: A riddle or sieve.
Glans :: Goiter.
Youngly :: Ignorantly; weakly.
Graceless :: "Unfortunate.  Cf. Grace  n.  4."
Nucament :: "A catkin or ament; the flower cluster of the hazel  pine  willow  and the like."
Amalgamating :: of Amalgamate
Relation :: A person connected by cosanguinity or affinity; a relative; a kinsman or kinswoman.
Unbecoming :: Not becoming; unsuitable; unfit; indecorous; improper.
Lepidopterist :: One who studies the Lepidoptera.
Families :: of Family
Bacchanalian :: Of or pertaining to the festival of Bacchus; relating to or given to reveling and dr
Foredetermine :: To determine or decree beforehand.
Found :: of Find
Kemp :: Alt. of Kempty
Garroted :: of Garrote
Baby farmer :: One who keeps a baby farm.
Calcarate :: Alt. of Calcarated
Hessian :: "Of or relating to Hesse  in Germany  or to the Hessians."
Formalize :: "To give form  or a certain form  to; to model."
Rodomel :: Juice of roses mixed with honey.
Sea pie :: "The oyster catcher  a limicoline bird of the genus Haematopus."
Gamogenesis :: The production of offspring by the union of parents of different sexes; sexual reprod
Fast :: "That which fastens or holds; especially  (Naut.) a mooring rope  hawser  or chain; -- calle
Sauce :: "Stewed or preserved fruit eaten with other food as a relish; as  apple sauce  cranberry sa
Urticaria :: "The nettle rash  a disease characterized by a transient eruption of red pimples and of
Saluter :: One who salutes.
Unamiable :: Not amiable; morose; ill-natured; repulsive.
Hematite :: "An important ore of iron  the sesquioxide  so called because of the red color of the po
Ram :: A hydraulic ram. See under Hydraulic.
Nonage :: Time of life before a person becomes of age; legal immaturity; minority.
Rise :: To come to mind; to be suggested; to occur.
Fighting :: "Occupied in war; being the scene of a battle; as  a fighting field."
Grandiloquent :: Speaking in a lofty style; pompous; bombastic.
Grindle stone :: A grindstone.
Fleshings :: "Flesh-colored tights  worn by actors dancers."
Ab :: "The fifth month of the Jewish year according to the ecclesiastical reckoning  the eleventh by
Scalp :: To remove the skin of.
Unpolled :: Not polled.
Felting :: "The material of which felt is made; also  felted cloth; also  the process by which it is
Fingered :: Marked with figures designating which finger should be used for each note.
Leased :: of Lease
Kail :: "Any cabbage  greens  or vegetables."
Vanadious :: "Pertaining to  or containing  vanadium; specifically  designating those compounds in w
Nubble :: To beat or bruise with the fist.
Faculty :: "Ability to act or perform  whether inborn or cultivated; capacity for any natural functi
Gree :: Rank; degree; position.
Fetch :: To reduce; to throw.
Genitocrural :: Pertaining to the genital organs and the thigh; -- applied especially to one of the 
Jactitation :: "A frequent tossing or moving of the body; restlessness  as in delirium."
After :: Below in rank; next to in order.
Heavenlyminded :: "Having the thoughts and affections placed on  or suitable for  heaven and heavenl
Revery :: An extravagant conceit of the fancy; a vision.
Ulmaceous :: "Of or pertaining to a suborder of urticaceous plants  of which the elm is the type."
Unmuffle :: "To take a covering from  as the face; to uncover."
Ungulous :: Same as Ungulate.
Forepossessed :: Holding or held formerly in possession.
Resultless :: "Being without result; as  resultless investigations."
Gibstaff :: A staff formerly used in fighting beasts on the stage.
Calice :: See Chalice.
After-sails :: "The sails on the mizzenmast  or on the stays between the mainmast and mizzenmast."
Glooming :: of Gloom
Scarf :: "In a piece which is to be united to another by a scarf joint  the part of the end or edge 
Accommodation :: An adjustment of differences; state of agreement; reconciliation; settlement.
Flameless :: Destitute of flame.
Gazeebo :: A summerhouse so situated as to command an extensive prospect.
Yockel :: The yaffle.
Fuel :: Anything that serves to feed or increase passion or excitement.
Herbalism :: The knowledge of herbs.
Forebodingly :: In a foreboding manner.
Hurdy-gurdy :: "A stringled instrument  lutelike in shape  in which the sound is produced by the fri
Gallowglass :: A heavy-armed foot soldier from Ireland and the Western Isles in the time of Edward /
Hegemonic :: Alt. of Hegemonical
Ubiquitariness :: "Quality or state of being ubiquitary  or ubiquitous."
Nitrogelatin :: An explosive consisting of gun cotton and camphor dissolved in nitroglycerin.
Variable :: "Those parts of the sea where a steady wind is not expected  especially the parts betwee
Ultratropical :: "Situated beyond  or outside of  the tropics; extratropical; also  having an excess
Holoblastic :: "Undergoing complete segmentation; composed entirely of germinal matter  the whole of
Aggrandizer :: "One who aggrandizes  or makes great."
Farmsteading :: A farmstead.
Febrifuge :: A medicine serving to mitigate or remove fever.
Foresightful :: Foresighted.
Good :: Not lacking or deficient; full; complete.
Fraternized :: of Fraternize
Gainstand :: To withstand; to resist.
Round :: "Ammunition for discharging a piece or pieces once; as  twenty rounds of ammunition were gi
Hagging :: of Hag
Frons :: The forehead; the part of the cranium between the orbits and the vertex.
Unload :: "To sell in large quantities  as stock; to get rid of."
Harmaline :: "An alkaloid found in the plant Peganum harmala. It forms bitter  yellow salts."
Venom :: Spite; malice; malignity; evil quality. Chaucer.
Glass maker :: Alt. of Glassmaker
Calamitous :: Suffering calamity; wretched; miserable.
Funicle :: The little stalk that attaches a seed to the placenta.
Holotricha :: "A group of ciliated Infusoria  having cilia all over the body."
Nicked :: of Nick
Washerwomen :: of Washerwoman
Fike :: See Fyke.
Flounce :: "An ornamental appendage to the skirt of a woman's dress  consisting of a strip gathered 
Lamellirostres :: "A group of birds embracing the Anseres and flamingoes  in which the bill is lamel
Rouet :: A small wheel formerly fixed to the pan of firelocks for discharging them.
Reembody :: To embody again.
Geometrical :: "Pertaining to  or according to the rules or principles of  geometry; determined by g
Zincoid :: "Pertaining to  or resembling  zinc; -- said of the electricity of the zincous plate in c
Remit :: "To refrain from exacting or enforcing; as  to remit the performance of an obligation."
Legator :: A testator; one who bequeaths a legacy.
Xiphura :: Same as Limuloidea. Called also Xiphosura.
Zealed :: Full of zeal; characterized by zeal.
Fallopian :: "Pertaining to  or discovered by  Fallopius; as  the Fallopian tubes or oviducts  the d
All :: "The whole quantity  extent  duration  amount  quality  or degree of; the whole; the whole nu
Fancying :: of Fancy
Leanness :: The condition or quality of being lean.
Alcoholature :: An alcoholic tincture prepared with fresh plants.
Administer :: "To perform the office of administrator; to act officially; as  A administers upon the
Grecque :: "An ornament supposed to be of Greek origin  esp. a fret or meander."
Undermasted :: Having masts smaller than the usual dimension; -- said of vessels.
Kanacka :: Alt. of Kanaka
Gadding :: "Going about much  needlessly or without purpose."
Financialist :: A financier.
Lege :: To allege; to assert.
House :: Those who dwell in the same house; a household.
Backboard :: "A board serving as the back part of anything  as of a wagon."
Cabal :: "A number of persons united in some close design  usually to promote their private views an
Jural :: Of or pertaining to jurisprudence.
Give :: "To set forth as a known quantity or a known relation  or as a premise from which to reason;
Grammates :: "Rudiments; first principles  as of grammar."
Nauseated :: of Nauseate
Fusteric :: The coloring matter of fustet.
Paint :: "Fig.: To color  stain  or tinge; to adorn or beautify with colors; to diversify with color
Fathom :: "A measure of length  containing six feet; the space to which a man can extend his arms; -
Runaway :: "Accomplished by running away or elopement  or during flight; as  a runaway marriage."
Faintness :: "The state of being faint; loss of strength  or of consciousness  and self-control."
Fringillaceous :: Fringilline.
Gust :: Intellectual taste; fancy.
Abscission :: The act or process of cutting off.
Frogfish :: An oceanic fish of the genus Antennarius or Pterophrynoides; -- called also mousefish an
Rhetizite :: Same as Rhaetizite.
Sagging :: of Sag
Accusatorially :: By way accusation.
Aggerose :: In heaps; full of heaps.
Fortnight :: The space of fourteen days; two weeks.
Fustian :: "A kind of coarse twilled cotton or cotton and linen stuff  including corduroy  velveteen
Rescued :: of Rescue
Leetmen :: of Leetman
Hobson's choice :: A choice without an alternative; the thing offered or nothing.
Rhamadan :: See Ramadan.
Sap :: "A narrow ditch or trench made from the foremost parallel toward the glacis or covert way of 
Nill :: Shining sparks thrown off from melted brass.
Fleshing :: of Flesh
Hostry :: A stable for horses.
Hunger-starve :: To starve with hunger; to famish.
Neuraxis :: "See Axis cylinder  under Axis."
Halloo :: An exclamation to call attention or to encourage one.
Sad :: Affected with grief or unhappiness; cast down with affliction; downcast; gloomy; mournful.
Jadish :: Unchaste; -- applied to a woman.
Santalum :: "A genus of trees with entire opposite leaves and small apetalous flowers. There are les
Lactucone :: "A white  crystalline  tasteless substance  found in the milky sap of species of Lactuc
Wanness :: "The quality or state of being wan; a sallow  dead  pale color; paleness; pallor; as  the
Gloated :: of Gloat
Sea perch :: The name is applied also to other species of fishes.
Gingal :: See Jingal.
Am :: "The first person singular of the verb be  in the indicative mode  present tense. See Be."
Flanneled :: Covered or wrapped in flannel.
Fanaticize :: To cause to become a fanatic.
Quab :: "An unfledged bird; hence  something immature or unfinished."
Feudary :: "Held by  or pertaining to  feudal tenure."
File :: "To rub  smooth  or cut away  with a file; to sharpen with a file; as  to file a saw or a to
Gage :: "A pledge or pawn; something laid down or given as a security for the performance of some ac
Fibulare :: "The bone or cartilage of the tarsus  which articulates with the fibula  and corresponds
Valerylene :: "A liquid hydrocarbon  C5H8; -- called also pentine."
Housing :: A niche for a statue.
Adoration :: Homage paid to one in high esteem; profound veneration; intense regard and love; ferven
Roast :: "That which is roasted; a piece of meat which has been roasted  or is suitable for being ro
Gallooned :: Furnished or adorned with galloon.
Valenciennes lace :: "A rich kind of lace made at Valenciennes  in France. Each piece is made throug
Heptylic :: "Pertaining to  or derived from  heptyl or heptane; as  heptylic alcohol.  Cf. /nanthyli
Getterup :: "One who contrives  makes  or arranges for  anything  as a book  a machine  etc."
Adhesion :: Agreement to adhere; concurrence; assent.
Nippitate :: Peculiary strong and good; -- said of ale or liquor.
Large :: "A musical note  formerly in use  equal to two longs  four breves  or eight semibreves."
Halloo :: To call or shout to; to hail.
Gainsayer :: "One who gainsays  contradicts  or denies."
Halo :: "An ideal glory investing  or affecting one's perception of  an object."
Nitride :: "A binary compound of nitrogen with a more metallic element or radical; as  boric nitride
Finery :: "Ornament; decoration; especially  excecially decoration; showy clothes; jewels."
Roisterer :: "A blustering  turbulent fellow."
Rife :: Having power; active; nimble.
Gill :: The flesh under or about the chin.
Leather :: "The skin of an animal  or some part of such skin  tanned  tawed  or otherwise dressed fo
Undersong :: The burden of a song; the chorus; the refrain.
Abought :: imp. &amp; p. p. of Aby.
Raddock :: The ruddock.
Hit :: A game won at backgammon after the adversary has removed some of his men. It counts less than
Acorn :: "A cone-shaped piece of wood on the point of the spindle above the vane  on the mast-head."
Caesurae :: of Caesura
Rejolt :: To jolt or shake again.
Fibrinogen :: "An albuminous substance existing in the blood  and in other animal fluids  which eith
Fulcra :: of Fulcrum
Reprize :: See Reprise.
Scabbiness :: The quality or state of being scabby.
Rashling :: A rash person.
Raw :: "Not trimmed  covered  or folded under; as  the raw edge of a piece of metal or of cloth."
Gazer :: One who gazes.
Gloze :: To smooth over; to palliate.
Gamble :: To play or game for money or other stake.
Renowner :: One who gives renown.
Gorge :: "A filling or choking of a passage or channel by an obstruction; as  an ice gorge in a rive
Goglet :: See Gurglet.
Recto-vesical :: Of or pertaining to both the rectum and the bladder.
Rail :: "A bar of timber or metal  usually horizontal or nearly so  extending from one post or suppo
Regulable :: Capable of being regulated.
Hellenism :: A phrase or form of speech in accordance with genius and construction or idioms of the 
Uncurl :: "To become uncurled  or straight."
Resistant :: "One who  or that which  resists."
Undulate :: "To move in  or have  undulations or waves; to vibrate; to wave; as  undulating air."
Agglutinative :: "Formed or characterized by agglutination  as a language or a compound."
Lavishing :: of Lavish
Henhouses :: of Henhouse
Rejoicing :: That which causes to rejoice; occasion of joy.
Verbosities :: of Verbosity
Ruck :: A heap; a rick.
Japanner :: "One who varnishes in the manner of the Japanese  or one skilled in the art."
Walkyr :: See Valkyria.
Headed :: "Furnished with a head (commonly as denoting intellectual faculties); -- used in compositi
Lavatory :: A place where gold is obtained by washing.
Backlash :: "The distance through which one part of connected machinery  as a wheel  piston  or scre
Ninescore :: "Nine times twenty  or one hundred and eighty."
Libretto :: A book containing the words of an opera or extended piece of music.
Guardianess :: A female guardian.
