Regnant :: "Exercising regal authority; reigning; as  a queen regnant."
Sanskrit :: "The ancient language of the Hindoos  long since obsolete in vernacular use  but preserv
Flasher :: A man of more appearance of wit than reality.
Affirmatory :: Giving affirmation; assertive; affirmative.
Fine :: "Not coarse  gross  or heavy"
Hagiographer :: One of the writers of the hagiographa; a writer of lives of the saints.
Hysteria :: "A nervous affection  occurring almost exclusively in women  in which the emotional and 
Salineness :: The quality or state of being salt; saltness.
Freshet :: A stream of fresh water.
Hair :: "A slender outgrowth from the chitinous cuticle of insects  spiders  crustaceans  and other 
Reentry :: "A resuming or retaking possession of what one has lately foregone; -- applied especially
Adjustment :: "The operation of bringing all the parts of an instrument  as a microscope or telescop
Cacaemia :: Alt. of Cachaemia
Heartbroken :: Overcome by crushing sorrow; deeply grieved.
Laguay :: A lackey.
Actinolite :: A bright green variety of amphibole occurring usually in fibrous or columnar masses.
Acanthopterous :: Acanthopterygious.
Wait :: "Hautboys  or oboes  played by town musicians; not used in the singular."
Retort :: "To bend or curve back; as  a retorted line."
Rewardful :: Yielding reward.
Frothing :: Exaggerated declamation; rant.
Schoolbook :: A book used in schools for learning lessons.
Labellum :: "The lower or apparently anterior petal of an orchidaceous flower  often of a very curio
Realism :: "Fidelity to nature or to real life; representation without idealization  and making no a
Ad libitum :: At one's pleasure; as one wishes.
Wash :: A liquid dentifrice.
Reddish :: Somewhat red; moderately red.
Heal :: "To reconcile  as a breach or difference; to make whole; to free from guilt; as  to heal dis
Reverentially :: In a reverential manner.
Vicar :: The incumbent of an appropriated benefice.
Force :: "Strength or power for war; hence  a body of land or naval combatants  with their appurtena
Achillean :: "Resembling Achilles  the hero of the Iliad; invincible."
Allowing :: of Allow
Heroicness :: Heroism.
Flocked :: of Flock
Lathe :: "The movable swing frame of a loom  carrying the reed for separating the warp threads and b
Receivedness :: "The state or quality of being received  accepted  or current; as  the receivedness 
Forbearant :: Forbearing.
Hygrometric :: Alt. of Hygrometrical
Caber :: A pole or beam used in Scottish games for tossing as a trial of strength.
Framing :: of Frame
Album :: "A white tablet on which anything was inscribed  as a list of names  etc."
Fitly :: "In a fit manner; suitably; properly; conveniently; as  a maxim fitly applied."
Fire :: The evolution of light and heat in the combustion of bodies; combustion; state of ignition.
Nibble :: "To bite upon something gently or cautiously; to eat a little of a thing  as by taking sma
Repulsive :: "Serving  or able  to repulse; repellent; as  a repulsive force."
Fencing :: "The art or practice of attack and defense with the sword  esp. with the smallsword. See 
Hexametric :: Alt. of Hexametrical
Agile :: "Having the faculty of quick motion in the limbs; apt or ready to move; nimble; active; as 
Yoke :: The quantity of land plowed in a day by a yoke of oxen.
Verbalizing :: of Verbalize
Herbarize :: See Herborize.
Rehabilitated :: of Rehabilitate
Ruption :: A breaking or bursting open; breach; rupture.
Headless :: "Having no head; beheaded; as  a headless body  neck  or carcass."
Reecho :: The echo of an echo; a repeated or second echo.
Foreland :: A piece of ground between the wall of a place and the moat.
Alertly :: In an alert manner; nimbly.
Ambassador :: Alt. of Embassador
Fuddling :: of Fuddle
Noble :: "Grand; stately; magnificent; splendid; as  a noble edifice."
Palatine :: The Palatine hill in Rome.
Fell :: "A skin or hide of a beast with the wool or hair on; a pelt; -- used chiefly in composition 
Wap :: To beat; to whap.
Notify :: "To make known; to declare; to publish; as  to notify a fact to a person."
Jeremiad :: Alt. of Jeremiade
Forearm :: That part of the arm or fore limb between the elbow and wrist; the antibrachium.
Footboard :: A board or narrow platfrom upon which one may stand or brace his feet
Remittance :: The sum or thing remitted.
Undertone :: A low or subdued tone or utterance; a tone less loud than usual.
Agree :: To make harmonious; to reconcile or make friends.
Fee :: "An estate of inheritance belonging to the owner  and transmissible to his heirs  absolutely 
Fresnel lamp :: Alt. of Fres'nel' lan'tern
Ringstraked :: Ring-streaked.
Hypodermis :: "Same as Hypoderma  2."
Scribblement :: A scribble.
Scrambler :: A greedy and unceremonious contestant.
Adjoining :: "Joining to; contiguous; adjacent; as  an adjoining room."
Amasser :: One who amasses.
Rendering :: "The process of trying out or extracting lard  tallow  etc.  from animal fat."
Novation :: "A substitution of a new debt for an old one; also  the remodeling of an old obligation.
Ream :: "To stretch out; to draw out into thongs  threads  or filaments."
Ladybug :: Same as Ladybird.
Hyacinthine :: Belonging to the hyacinth; resemblingthe hyacinth; in color like the hyacinth.
Robust :: Violent; rough; rude.
Foreteller :: One who predicts.
Nouriture :: Nurture.
Flunk :: "To fail in; to shirk  as a task or duty."
Husband :: A married man; a man who has a wife; -- the correlative to wife.
Adequateness :: The quality of being adequate; suitableness; sufficiency; adequacy.
Saltatoria :: "A division of Orthoptera including grasshoppers  locusts  and crickets."
Underactor :: A subordinate actor.
Reclamation :: The act or process of reclaiming.
Rigor :: "See 1st Rigor  2."
Raspis :: The raspberry.
Adenoidal :: Glandlike; glandular.
Lethargical :: "Pertaining to  affected with  or resembling  lethargy; morbidly drowsy; dull; heavy.
Readjustment :: A second adjustment; a new or different adjustment.
Half :: Part; side; behalf.
Just :: Conforming or conformable to rectitude or justice; not doing wrong to any; violating no righ
Heaviness :: The state or quality of being heavy in its various senses; weight; sadness; sluggishnes
Relinquent :: Relinquishing.
Forcipal :: Forked or branched like a pair of forceps; constructed so as to open and shut like a pai
Gravel :: "A deposit of small calculous concretions in the kidneys and the urinary or gall bladder; 
A :: "An expletive  void of sense  to fill up the meter"
Laying :: of Lay
Varices :: of Varix
Scathless :: Unharmed.
Nifle :: A trifle.
Scleroderm :: "Hardened  or bony  integument of various animals."
Gladiate :: "Sword-shaped; resembling a sword in form  as the leaf of the iris  or of the gladiolus.
Native :: "Conferred by birth; derived from origin; born with one; inherent; inborn; not acquired; a
Raisin :: A grape dried in the sun or by artificial heat.
Re-resolve :: To resolve again.
Runner :: A movable slab or rubber used in grinding or polishing a surface of stone.
Rescription :: A writing back; the answering of a letter.
Fantastic :: Having the nature of a phantom; unreal.
Water gall :: "A watery appearance in the sky  accompanying the rainbow; a secondary or broken rainb
Abaction :: Stealing cattle on a large scale.
Fumble :: To handle much; to play childishly; to turn over and over.
Lance :: "A weapon of war  consisting of a long shaft or handle and a steel blade or head; a spear c
Affinity :: "A relation between species or highe/ groups dependent on resemblance in the whole plan 
-ably :: "A suffix composed of -able and the adverbial suffix -ly; as  favorably."
Lepidine :: "An organic base  C9H6.N.CH3  metameric with quinaldine  and obtained by the distillatio
Zeekoe :: A hippopotamus.
Foot :: "Soldiers who march and fight on foot; the infantry  usually designated as the foot  in dist
Sea gull :: Any gull living on the seacoast.
Humanist :: One versed in knowledge of human nature.
Faith :: "The belief in the historic truthfulness of the Scripture narrative  and the supernatural o
Haw :: "To turn to the near side  or toward the driver; -- said of cattle or a team: a word used by 
Holloa :: Same as Hollo.
Refound :: To found or cast anew.
Reget :: To get again.
Scar :: "An isolated or protruding rock; a steep  rocky eminence; a bare place on the side of a moun
Madrier :: A plank or beam used for supporting the earth in mines or fortifications.
Ubiquitary :: A ubiquist.
Homotypy :: A term suggested by Haeckel to be instead of serial homology. See Homotype.
Grip :: An energetic or tenacious grasp; a holding fast; strength in grasping.
Urtica :: "A genus of plants including the common nettles. See Nettle  n."
Haematothorax :: Same as Hemothorax.
Gum :: "The dense tissues which invest the teeth  and cover the adjacent parts of the jaws."
Rent :: "A certain periodical profit  whether in money  provisions  chattels  or labor  issuing out 
Heptarchic :: Of or pertaining to a heptarchy; constituting or consisting of a heptarchy.
Adornation :: Adornment.
Vampirism :: The actions of a vampire; the practice of bloodsucking.
Gudgeon :: "A small European freshwater fish (Gobio fluviatilis)  allied to the carp. It is easily c
Taffy :: A kind of candy made of molasses or brown sugar boiled down and poured out in shallow pans.
Half-yearly :: Two in a year; semiannual. -- adv. Twice in a year; semiannually.
According :: Agreeing; in agreement or harmony; harmonious.
Riveting :: of Rivet
V :: "As a numeral  V stands for five  in English and Latin."
Echinoderm :: One of the Echinodermata.
Accountable :: Capable of being accounted for; explicable.
Fiche :: See FitchE.
Receipt :: "Hence  a recess; a retired place."
Gardant :: "Turning the head towards the spectator  but not the body; -- said of a lion or other bea
Nodosity :: The quality of being knotty or nodose; resemblance to a node or swelling; knottiness.
Gahnite :: Zinc spinel; automolite.
Retraction :: "The act of retracting  or drawing back; the state of being retracted; as  the retract
Unconfounded :: Not confounded.
Humanity :: "The branches of polite or elegant learning; as language  rhetoric  poetry  and the anci
Acceleratory :: Accelerative.
Abdicate :: "To relinquish or renounce a throne  or other high office or dignity."
Glorify :: "To make glorious by bestowing glory upon; to confer honor and distinction upon; to eleva
Niggard :: To act the niggard toward; to be niggardly.
Vauntful :: Given to vaunting or boasting; vainly ostentatious; boastful; vainglorious.
Resolvableness :: The quality of being resolvable; resolvability.
Labefy :: To weaken or impair.
Yieldance :: The act of yielding; concession.
Acrimony :: "A quality of bodies which corrodes or destroys others; also  a harsh or biting sharpnes
Kawn :: An inn.
Wart hog :: "Either one of two species of large  savage African wild hogs of the genus Phacoch/rus. 
Horseshoe :: The Limulus of horsehoe crab.
Horometer :: An instrument for measuring time.
Scraber :: The black guillemot.
Husbandry :: Care of domestic affairs; economy; domestic management; thrift.
Unsincere :: Not sincere or pure; insincere.
Hencoop :: A coop or cage for hens.
Sabaean :: Same as Sabian.
How :: At what price; how dear.
Giaour :: "An infidel; -- a term applied by Turks to disbelievers in the Mohammedan religion  especi
Resistance :: A means or method of resisting; that which resists.
Abstraction :: "An idea or notion of an abstract  or theoretical nature; as  to fight for mere abstr
Unprinciple :: To destroy the moral principles of.
Sacking :: of Sack
Adesmy :: The division or defective coherence of an organ that is usually entire.
Relievable :: Capable of being relieved; fitted to recieve relief.
Notch :: A hollow cut in anything; a nick; an indentation.
Uran-utan :: The orang-utang
Holp :: of Help
Venison :: "Formerly  the flesh of any of the edible beasts of the chase  also of game birds; now  t
Rogue :: A worthless plant occuring among seedlings of some choice variety.
Uneasity :: In an easy manner.
Lift :: To live by theft.
Jump :: An abrupt interruption of level in a piece of brickwork or masonry.
Frilled :: of Frill
Reading :: "Study of books; literary scholarship; as  a man of extensive reading."
Air gas :: See under Gas.
Fender :: Anything serving as a cushion to lessen the shock when a vessel comes in contact with anot
Unseason :: To make unseasoned; to deprive of seasoning.
Flatlency :: The state or quality of being flatulent.
Great-heartedness :: The quality of being greathearted; high-mindedness; magnanimity.
Sea peach :: "A beautiful American ascidian (Cynthia  / Halocynthia  pyriformis) having the size  fo
Tail :: "The bottom or lower portion of a member or part  as a slate or tile."
Horner :: One who horns or cuckolds.
Accoutre :: "To furnish with dress  or equipments  esp. those for military service; to equip; to att
Macropodous :: Having long legs or feet.
Vasoformative :: "Concerned in the development and formation of blood vessels and blood corpuscles; 
Gaberdine :: A coarse frock or loose upper garment formerly worn by Jews; a mean dress.
Retection :: Act of disclosing or uncovering something concealed.
Hemophilia :: See Hematophilia.
Ragious :: Raging; furious; rageful.
Float :: "To cause to float; to cause to rest or move on the surface of a fluid; as  the tide floate
Gastropoda :: "One of the classes of Mollusca  of great extent. It includes most of the marine spira
Faradism :: Alt. of Faradization
Adventuring :: of Adventure
Flourish :: To use florid language; to indulge in rhetorical figures and lofty expressions; to be fl
Absence :: "Inattention to things present; abstraction (of mind); as  absence of mind."
Aerial :: "Consisting of air; resembling  or partaking of the nature of air. Hence: Unsubstantial; u
Hoarhound :: Same as Horehound.
Nosocomial :: "Of or pertaining to a hospital; as  nosocomial atmosphere."
Hydrophyllia :: of Hydrophyllium
Forborne :: p. p. of Forbear.
Sagittal :: "In the mesial plane; mesial; as  a sagittal section of an animal."
Scapula :: The principal bone of the shoulder girdle in mammals; the shoulder blade.
Flourish :: "To adorn with flowers orbeautiful figures  either natural or artificial; to ornament wi
Necessitous :: Very needy or indigent; pressed with poverty.
Lambrequin :: A leather flap hanging from a cuirass.
Uncock :: "To deprive of its cocked shape  as a hat  etc."
Gable :: "A decorative member having the shape of a triangular gable  such as that above a Gothic ar
Unkemmed :: Unkempt.
Forgave :: of Forgive
Saber :: Alt. of Sabre
Ground :: "In sculpture  a flat surface upon which figures are raised in relief."
Pace :: "To develop  guide  or control the pace or paces of; to teach the pace; to break in."
Naturality :: Nature; naturalness.
Groundsill :: "See Ground plate (a)  under Ground"
Unambition :: The absence of ambition.
Reduvid :: "Any hemipterous insect of the genus Redivius  or family Reduvidae. They live by sucking 
Reviewer :: "One who reviews or reexamines; an inspector; one who examines publications critically  
Gayety :: "Finery; show; as  the gayety of dress."
Find :: To attain to; to arrive at; to acquire.
Resting :: of Rest
Foolery :: An act of folly or weakness; a foolish practice; something absurd or nonsensical.
Foil :: "To blunt; to dull; to spoil; as  to foil the scent in chase."
Fluted :: "Thin; fine; clear and mellow; flutelike; as  fluted notes."
Heteromerous :: With the parts not corresponding in number.
Gore :: A small traingular piece of land.
Hippogriff :: "A fabulous winged animal  half horse and half griffin."
Necessary :: A privy; a water-closet.
Histogenesis :: The formation and development of organic tissues; histogeny; -- the opposite of hist
Wallwort :: "The dwarf elder  or danewort (Sambucus Ebulus)."
Haematemesis :: Same as Hematemesis.
Highflying :: Extravagant in opinions or ambition.
Fresh :: A stream or spring of fresh water.
Sarcastical :: "Expressing  or expressed by  sarcasm; characterized by  or of the nature of  sarcasm
Pacane :: A species of hickory. See Pecan.
Unstudied :: Not spent in study.
Scapegoat :: "Hence  a person or thing that is made to bear blame for others."
Hurrah :: To utter hurrahs; to huzza.
Lest :: To listen.
Famous :: "Celebrated in fame or public report; renowned; mach talked of; distinguished in story; --
Accommodation :: "Whatever supplies a want or affords ease  refreshment  or convenience; anything fu
Repaster :: One who takes a repast.
Galactopoietic :: Increasing the flow of milk; milk-producing. -- n. A galactopoietic substance.
Negatively :: In the form of speech implying the absence of something; -- opposed to positively.
Folio :: "A book made of sheets of paper each folded once (four pages to the sheet); hence  a book o
Ultimata :: of Ultimatum
Fusil :: "A light kind of flintlock musket  formerly in use."
Unfraught :: Not fraught; not burdened.
Scincoid :: "Of or pertaining to the family Scincidae  or skinks."
Job :: To seek private gain under pretense of public service; to turn public matters to private adva
Jeerer :: A scoffer; a railer; a mocker.
Neck :: "That part of a violin  guitar  or similar instrument  which extends from the head to the bo
Neuropterous :: Neuropteral.
Rewarder :: One who rewards.
Fixity :: "Fixedness; as  fixity of tenure; also  that which is fixed."
Grass :: To produce grass.
Reason :: "To support with reasons  as a request."
Hoaxer :: One who hoaxes.
Sanctity :: The state or quality of being sacred or holy; holiness; saintliness; moral purity; godli
Geering :: "See Gear  Gearing."
Khanate :: Dominion or jurisdiction of a khan.
Relaying :: of Relay
Yearly :: "Lasting a year; as  a yearly plant."
Hegemony :: Leadership; preponderant influence or authority; -- usually applied to the relation of a
Liability :: "That which one is under obligation to pay  or for which one is liable."
Hornwort :: "An aquatic plant (Ceratophyllum)  with finely divided leaves."
East :: "Formerly  the part of the United States east of the Alleghany Mountains  esp. the Eastern  
Label :: "A writing annexed by way of addition  as a codicil added to a will."
Howled :: of Howl
Hairworm :: "A nematoid worm of the genus Gordius  resembling a hair. See Gordius."
Grantee :: The person to whom a grant or conveyance is made.
Scribbling :: Writing hastily or poorly.
Ragged :: Rough; shaggy; rugged.
Saccus :: A sac.
fayed :: of Fay
Sapan wood :: "A dyewood yielded by Caesalpinia Sappan  a thorny leguminous tree of Southern Asia an
Accustom :: To be wont.
Roundhead :: "A nickname for a Puritan. See Roundheads  the  in the Dictionary of Noted Names in Fic
Horizon :: The circle which bounds that part of the earth's surface visible to a spectator from a gi
Reconquest :: A second conquest.
Unhelm :: To deprive of the helm or helmet.
Aldermanic :: "Relating to  becoming to  or like  an alderman; characteristic of an alderman."
Underletter :: A tenant or lessee who grants a lease to another.
Ramp :: "To move by leaps  or as by leaps; hence  to move swiftly or with violence."
Zedoary :: "A medicinal substance obtained in the East Indies  having a fragrant smell  and a warm  
Sapphire :: "Any humming bird of the genus Hylocharis  native of South America. The throat and breas
Resident :: "A diplomatic representative who resides at a foreign court; -- a term usualy applied to
Lepidopter :: One of the Lepidoptera.
Find :: "To meet with  or light upon  accidentally; to gain the first sight or knowledge of  as of s
Nip :: A blast; a killing of the ends of plants by frost.
Faint :: To cause to faint or become dispirited; to depress; to weaken.
Groin :: The snout of a swine.
Adiactinic :: Not transmitting the actinic rays.
Gallantry :: Splendor of appearance; ostentatious finery.
Humectate :: To moisten; to wet.
Recuperator :: Same as Regenerator.
Grimalkin :: "An old cat  esp. a she-cat."
Scorbutic :: Alt. of Scorbutical
Cake :: "To form into a cake  or mass."
Easting :: The distance measured toward the east between two meridians drawn through the extremities
Age :: A century; the period of one hundred years.
Sacrificed :: of Sacrifice
Levyne :: Alt. of Levynite
Flowery :: Full of flowers; abounding with blossoms.
Recrement :: "Superfluous matter separated from that which is useful; dross; scoria; as  the recreme
Regular :: "Thorough; complete; unmitigated; as  a regular humbug."
Untraded :: "Not traded in or bartered; hence  not hackneyed; unusual; not common."
Lanyard :: "A strong cord  about twelve feet long  with an iron hook at one end a handle at the othe
Jeoparding :: of Jeopard
Rebellion :: "Open resistance to  or defiance of  lawful authority."
Rank :: "To be ranged; to be set or disposed  as in a particular degree  class  order  or division."
Float :: "The hollow  metallic ball of a self-acting faucet  which floats upon the water in a cister
Root :: "The underground portion of a plant  whether a true root or a tuber  a bulb or rootstock  as
Foothot :: Hastily; immediately; instantly; on the spot; hotfloot.
Acorn :: See Acorn-shell.
Fruit :: "The spore cases or conceptacles of flowerless plants  as of ferns  mosses  algae  etc.  wi
Ravish :: To seize and carry away by violence; to snatch by force.
Taboring :: of Tabor
Frank :: "The privilege of sending letters or other mail matter  free of postage  or without charge;
Rondel :: A small round tower erected at the foot of a bastion.
Rhododendron :: "A genus of shrubs or small trees  often having handsome evergreen leaves  and remar
Aga :: Alt. of Agha
Harborous :: Hospitable.
Warbler :: "One who  or that which  warbles; a singer; a songster; -- applied chiefly to birds."
Leger :: Light; slender; slim; trivial.
Neoterized :: of Neoterize
Gelatine :: Same as Gelatin.
Revolt :: "To be disgusted  shocked  or grossly offended; hence  to feel nausea; -- with at; as  the
Reel :: "A frame with radial arms  or a kind of spool  turning on an axis  on which yarn  threads  l
Reverberatory :: Producing reverberation; acting by reverberation; reverberative.
Harrower :: One who harries.
Fated :: Exempted by fate.
Novatian :: "One of the sect of Novatius  or Novatianus  who held that the lapsed might not be recei
Float :: To flood; to overflow; to cover with water.
Hesitatingly :: With hesitation or doubt.
Keel :: To cool; to skim or stir.
Galleries :: of Gallery
Heterochrony :: "In evolution  a deviation from the typical sequence in the formation of organs or p
Grow :: To increase in size by a natural and organic process; to increase in bulk by the gradual ass
Gradualness :: The quality or state of being gradual; regular progression or gradation; slowness.
Horsiness :: "Fondness for  or interest in  horses."
Jerquer :: A customhouse officer who searches ships for unentered goods.
Foreleader :: One who leads others by his example; aguide.
Sclerenchyma :: "Vegetable tissue composed of short cells with thickened or hardened walls  as in nu
Affeer :: "To assess or reduce  as an arbitrary penalty or amercement  to a certain and reasonable s
Ward :: The state of being under guard or guardianship; confinement under guard; the condition of a 
Affliction :: "The state of being afflicted; a state of pain  distress  or grief."
Tackle :: "To begin to deal with; as  to tackle the problem."
Scintillated :: of Scintillate
Scythemen :: of Scytheman
Agrarian :: Wild; -- said of plants growing in the fields.
Hybridizer :: One who hybridizes.
Referrer :: One who refers.
Unfolder :: "One who  or that which  unfolds."
Scranching :: of Scranch
Remiss :: The act of being remiss; inefficiency; failure.
Jigger :: "One who  or that which  jigs; specifically  a miner who sorts or cleans ore by the proces
Jacksmith :: "A smith who makes jacks. See 2d Jack  4  c."
Unconscionable :: "Not conscionable; not conforming to reason; unreasonable; exceeding the limits of
Naval :: "Having to do with shipping; of or pertaining to ships or a navy; consisting of ships; as  
Saliretin :: A yellow amorphous resinoid substance obtained by the action of dilute acids on saligen
Replevied :: of Replevy
Riverhood :: The quality or state of being a river.
Rouge :: "To tint with rouge; as  to rouge the face or the cheeks."
Rachises :: of Rachis
Neutralized :: of Neutralize
Name :: To mention by name; to utter or publish the name of; to refer to by distinctive title; to me
Hypermetamorphosis :: "A kind of metamorphosis  in certain insects  in which the larva itself underg
Rabid :: "Affected with the distemper called rabies; mad; as  a rabid dog or fox."
Factory :: "The body of factors in any place; as  a chaplain to a British factory."
Recherche :: "Sought out with care; choice. Hence: of rare quality  elegance  or attractiveness; pec
Fordrunken :: Utterly drunk; very drunk.
Layer :: An artificial oyster bed.
Financier :: One charged with the administration of finance; an officer who administers the public r
Fine :: (Used ironically.)
Reinfectious :: Capable of reinfecting.
Remainder-man :: "One who has an estate after a particular estate is determined. See Remainder  n.  
Kainozoic :: See Cenozoic.
Lampas :: An inflammation and swelling of the soft parts of the roof of the mouth immediately behind
Zeal :: To be zealous.
Yesternight :: On the last night.
Hack :: To use as a hack; to let out for hire.
Grasp :: To effect a grasp; to make the motion of grasping; to clutch; to struggle; to strive.
Xanthogen :: Persulphocyanogen.
High-top :: A ship's masthead.
Echinoidea :: "The class Echinodermata which includes the sea urchins. They have a calcareous  usual
Acceptive :: Fit for acceptance.
Gabelleman :: A gabeler.
Untidy :: Not tidy or neat; slovenly.
Jab :: "To thrust; to stab; to punch. See Job  v. t."
Usher :: "To introduce or escort  as an usher  forerunner  or harbinger; to forerun; -- sometimes fo
Acid :: "Sour  sharp  or biting to the taste; tart; having the taste of vinegar: as  acid fruits or 
Harlequin :: "A buffoon  dressed in party-colored clothes  who plays tricks  often without speaking 
Libertarian :: "Pertaining to liberty  or to the doctrine of free will  as opposed to the doctrine o
Gnomonist :: One skilled in gnomonics.
Sagenite :: Acicular rutile occurring in reticulated forms imbedded in quartz.
Verities :: of Verity
Resino-electric :: Containing or exhibiting resinous electricity.
Gutted :: of Gut
Futchel :: The jaws between which the hinder end of a carriage tongue is inserted.
Reeler :: The grasshopper warbler; -- so called from its note.
Adultery :: The fine and penalty imposed for the offense of adultery.
Ruck :: "To cower; to huddle together; to squat; to sit  as a hen on eggs."
Nataloin :: A bitter crystalline substance constituting the essential principle of Natal aloes.  Cf.
Latreutical :: Of or pertaining to latria.
Valencies :: of Valency
Haymaking :: The operation or work of cutting grass and curing it for hay.
Floorage :: Floor space.
Y :: A portion of track consisting of two diverging tracks connected by a cross track.
Fearful :: "Full of fear  apprehension  or alarm; afraid; frightened."
Samian :: A native or inhabitant of Samos.
Hurt :: "To impar the value  usefulness  beauty  or pleasure of; to damage; to injure; to harm."
Floater :: One who floats or swims.
Hinged :: Furnished with hinges.
Sack :: "To plunder or pillage  as a town or city; to devastate; to ravage."
M :: "As a numeral  M stands for one thousand  both in English and Latin."
Grane :: See Groan.
Leucous :: "White; -- applied to albinos  from the whiteness of their skin and hair."
Fantastical :: Fanciful; unreal; whimsical; capricious; fantastic.
Nucleoli :: of Nucleolus
Famish :: "To suffer extreme hunger or thirst  so as to be exhausted in strength  or to come near to
Revery :: Same as Reverie.
Repousse :: Repousse work.
Admirative :: Relating to or expressing admiration or wonder.
Vest :: "To clothe with possession; as  to vest a person with an estate; also  to give a person an i
Lighty :: Illuminated.
Taguan :: "A large flying squirrel (Pteromys petuarista). Its body becomes two feet long  with a lar
Lactescence :: "The state or quality of producing milk  or milklike juice; resemblance to milk; a mi
Lay :: A plan; a scheme.
Refrigeratory :: "The chamber  or tank  in which ice is formed  in an ice machine."
Rubigo :: "same as Rust  n.  2."
Filth :: Anything that sullies or defiles the moral character; corruption; pollution.
Hesp :: A measure of two hanks of linen thread.
Harlot :: A person given to low conduct; a rogue; a cheat; a rascal.
Forester :: "A lepidopterous insect belonging to Alypia and allied genera; as  the eight-spotted for
Sea holly :: An evergeen seashore plant (Eryngium maritimum). See Eryngium.
Unconsummate :: Not consummated; not accomplished.
Gavelkind :: "A tenure by which land descended from the father to all his sons in equal portions  an
Race :: "The current of water that turns a water wheel  or the channel in which it flows; a mill rac
Vetturini :: of Vetturino
Hoggish :: Swinish; gluttonous; filthy; selfish.
Satirist :: "One who satirizes; especially  one who writes satire."
Fabric :: The structure of anything; the manner in which the parts of a thing are united; workmanshi
Upbuoyance :: The act of buoying up; uplifting.
Admiralship :: "The office or position oaf an admiral; also  the naval skill of an admiral."
Lady's mantle :: "A genus of rosaceous herbs (Alchemilla)  esp. the European A. vulgaris  which has 
Aculeiform :: Like a prickle.
Rhinocerial :: Alt. of Rhinocerical
Facsimile :: To make a facsimile of.
Hoa :: A stop; a halt; a moderation of pace.
Savanilla :: The tarpum.
Heterodox :: "Contrary to  or differing from  some acknowledged standard  as the Bible  the creed of
Retrocede :: "To cede or grant back; as  to retrocede a territory to a former proprietor."
Gouge :: "An incising tool which cuts forms or blanks for gloves  envelopes  etc. from leather  pape
Background :: "Anything behind  serving as a foil; as  the statue had a background of red hangings."
First :: "Most eminent or exalted; most excellent; chief; highest; as  Demosthenes was the first ora
Walnut :: "The fruit or nut of any tree of the genus Juglans; also  the tree  and its timber. The se
Raised :: "Lifted up; showing above the surroundings; as  raised or embossed metal work."
Lad :: "p. p. of Lead  to guide."
Action :: "A process or condition of acting or moving  as opposed to rest; the doing of something; e
Sashery :: A collection of sashes; ornamentation by means of sashes.
Ricketish :: Rickety.
Aerodynamic :: Pertaining to the force of air in motion.
Gadhelic :: "Of or pertaining to that division of the Celtic languages  which includes the Irish  Ga
Greed :: "An eager desire or longing; greediness; as  a greed of gain."
Fineless :: Endless; boundless.
Unction :: "That quality in language  address  or the like  which excites emotion; especially  stron
Homomorphism :: "The possession  in one species of plants  of only one kind of flowers; -- opposed t
Gumminess :: The state or quality of being gummy; viscousness.
fertileness :: Fertility.
Retractor :: A muscle serving to draw in any organ or part. See Illust. under Phylactolaemata.
Humble :: "To bring low; to reduce the power  independence  or exaltation of; to lower; to abase; to
Rating :: of Rate
Flaming :: Of the color of flame; high-colored; brilliant; dazzling.
Fife :: "A small shrill pipe  resembling the piccolo flute  used chiefly to accompany the drum in mi
Vespa :: A genus of Hymenoptera including the common wasps and hornets.
Frock :: To make a monk of.  Cf. Unfrock.
Neologist :: "An innovator in any doctrine or system of belief  especially in theology; one who intr
Represent :: "To exhibit to another mind in language; to show; to give one's own impressions and jud
Scrimmage :: The struggle in the rush lines after the ball is put in play.
Foreward :: The van; the front.
Helical :: "Of or pertaining to  or in the form of  a helix; spiral; as  a helical staircase; a heli
Unspell :: To break the power of (a spell); to release (a person) from the influence of a spell; to 
Scientist :: One learned in science; a scientific investigator; one devoted to scientific study; a s
Sarcorhamphi :: A division of raptorial birds comprising the vultures.
Fount :: A font.
Gimbal :: Alt. of Gimbals
Neck :: "A long narrow tract of land projecting from the main body  or a narrow tract connecting two
Free :: "To make free; to set at liberty; to rid of that which confines  limits  embarrasses  oppres
Adulteress :: A woman who violates her religious engagements.
Languishing :: "Amorously pensive; as  languishing eyes  or look."
Light :: "Easy to admit influence; inconsiderate; easily influenced by trifling considerations; unst
Kelt :: "See Kilt  n."
Restful :: "Giving rest; freeing from toil  trouble  etc."
Hypercritical :: Excessively nice or exact.
Guidon :: "A small flag or streamer  as that carried by cavalry  which is broad at one end and nearl
Reeving :: of Reeve
Legendary :: Of or pertaining to a legend or to legends; consisting of legends; like a legend; fabul
Rapacious :: Given to plunder; disposed or accustomed to seize by violence; seizing by force.
Albuminiparous :: Producing albumin.
Unpitied :: Pitiless; merciless.
Radiator :: "That which radiates or emits rays  whether of light or heat; especially  that part of a
Cabinet :: "A small room  or retired apartment; a closet."
Rowelling :: of Rowel
Rickrack :: A kind of openwork edging made of serpentine braid.
Almondine :: See Almandine
Riven :: of Rive
Hangnest :: A bird which builds such a nest; a hangbird.
Graciousness :: Quality of being gracious.
Ruminate :: To meditate or ponder over; to muse on.
Rough :: "To cut or make in a hasty  rough manner; -- with out; as  to rough out a carving  a sketch
Acquiesce :: "To rest satisfied  or apparently satisfied  or to rest without opposition and disconte
Hydropathical :: Of or pertaining to hydropathy.
Gillian :: "A girl; esp.  a wanton; a gill."
Gauging :: of Gauge
Good :: "Wares; commodities; chattels; -- formerly used in the singular in a collective sense. In la
Acatalectic :: A verse which has the complete number of feet and syllables.
Ring :: "A sound; especially  the sound of vibrating metals; as  the ring of a bell."
Rawhide :: "A cowhide  or coarse riding whip  made of untanned (or raw) hide twisted."
Gravelled :: of Gravel
Hote :: To command; to enjoin.
Palliard :: A born beggar; a vagabond.
Flota :: "A fleet; especially  a /eet of Spanish ships which formerly sailed every year from Cadiz t
Funge :: A blockhead; a dolt; a fool.
Yelled :: of Yell
Uncivilization :: The state of being uncivilized; savagery or barbarism.
Homophonous :: "Originally  sounding alike; of the same pitch; unisonous; monodic."
Ribanded :: Ribboned.
Vermiculate :: "Crawling or creeping like a worm; hence  insinuating; sophistical."
Gave :: of Give
Fers :: Fierce.
Frequent :: To make full; to fill.
Tailrace :: "The channel in which tailings  suspended in water  are conducted away."
Albuminiferous :: Supplying albumen.
Force :: "To do violence to; to overpower  or to compel by violence to one;s will; especially  to ra
Vein :: "A train of association  thoughts  emotions  or the like; a current; a course."
Umbilicated :: "Depressed in the middle  like a navel  as a flower  fruit  or leaf; navel-shaped; ha
Gablet :: "A small gable  or gable-shaped canopy  formed over a tabernacle  niche  etc."
Respect :: "An expression of respect of deference; regards; as  to send one's respects to another."
Scapulae :: of Scapula
Amain :: "To lower the topsail  in token of surrender; to yield."
Receipt :: "A formulary according to the directions of which things are to be taken or combined; a r
Lacrymary :: Alt. of Lacrymose
Upward :: Alt. of Upwards
Allwork :: "Domestic or other work of all kinds; as  a maid of allwork  that is  a general servant."
Acacin :: Alt. of Acacine
Filibusterism :: The characteristics or practices of a filibuster.
Notwheat :: Wheat not bearded.
Scholia :: of Scholium
Raspatory :: A surgeon's rasp.
Saltigradae :: A tribe of spiders including those which lie in wait and leap upon their prey; the le
Lep :: of Leap. Leaped.
Take :: "To accept the word or offer of; to receive and accept; to bear; to submit to; to enter into
Vaulting :: of Vault
Run :: "To move  proceed  advance  pass  go  come  etc.  swiftly  smoothly  or with quick action; --
Leaper :: A kind of hooked instrument for untwisting old cordage.
Rocambole :: "A name of Allium Scorodoprasum and A. Ascalonium  two kinds of garlic  the latter of w
Scutibranchiate :: Having the gills protected by a shieldlike shell; of or pertaining to the Scutibr
Rictus :: "The gape of the mouth  as of birds; -- often resricted to the corners of the mouth."
Helicoidal :: Same as Helicoid.
Alcohometer :: Alt. of Alcohometric
Score :: "To write down in proper order and arrangement; as  to score an overture for an orchestra. 
Fashionable :: "Established or favored by custom or use; current; prevailing at a particular time; a
Finesse :: To use artifice or stratagem.
Hermaphrodism :: See Hermaphroditism.
Alcayde :: "The warden  or keeper of a jail."
Rabbin :: Same as Rabbi.
Vanillate :: A salt of vanillic acid.
Hydrophytology :: The branch of botany which treats of water plants.
Rody :: Ruddy.
Genevanism :: Strict Calvinism.
Nomination :: The act of naming or nominating; designation of a person as a candidate for office; th
Vaporer :: One who vapors; a braggart.
Unbosomed :: of Unbosom
Screw :: A steam vesel propelled by a screw instead of wheels; a screw steamer; a propeller.
Rueful :: Expressing sorrow.
Focus :: A point so related to a conic section and certain straight line called the directrix that t
Run :: "To flow  as a liquid; to ascend or descend; to course; as  rivers run to the sea; sap runs u
Accentuation :: pitch or modulation of the voice in reciting portions of the liturgy.
Yellowwood :: "The wood of any one of several different kinds of trees; also  any one of the trees t
Savorless :: Having no savor; destitute of smell or of taste; insipid.
Raft :: imp. &amp; p. p. of Reave.
Alms :: "Anything given gratuitously to relieve the poor  as money  food  or clothing; a gift of cha
Hoiden :: To romp rudely or indecently.
Agreement :: "State of agreeing; harmony of opinion  statement  action  or character; concurrence; c
Vexillary :: Of or pertaining to an ensign or standard.
Forthwith :: Immediately; without delay; directly.
Paeonine :: "An artifical red nitrogenous dyestuff  called also red coralline."
Rememorative :: Tending or serving to remind.
Labyrinthibranch :: Of or pertaining to the Labyrinthici.
Aforehand :: Prepared; previously provided; -- opposed to behindhand.
Schoolship :: "A vessel employed as a nautical training school  in which naval apprentices receive t
Unascried :: Not descried.
Fermentable :: "Capable of fermentation; as  cider and other vegetable liquors are fermentable."
Wanghee :: "The Chinese name of one or two species of bamboo  or jointed cane  of the genus Phyllost
Gainsome :: Prepossessing; well-favored.
Ruining :: of Ruin
Feed :: "To graze; to cause to be cropped by feeding  as herbage by cattle; as  if grain is too forw
Scald :: Scurf on the head. See Scall.
Groin :: The surface formed by two such vaults.
Hocuspocus :: A juggler or trickster.
Fiftieth :: One of fifty equal parts; the quotient of a unit divided by fifty.
Ventriloquizing :: of Ventriloquize
Gibberish :: "Unmeaning; as  gibberish language."
Jack :: "To move or lift  as a house  by means of a jack or jacks. See 2d Jack  n.  5."
Humstrum :: An instrument out of tune or rudely constructed; music badly played.
Hobnob :: Have or have not; -- a familiar invitation to reciprocal drinking.
Calid :: Hot; burning; ardent.
Hersal :: Rehearsal.
Hushing :: of Hush
Allurer :: "One who  or that which  allures."
Libidinist :: One given to lewdness.
Hive :: A place swarming with busy occupants; a crowd.
Revelation :: "Specifically  the last book of the sacred canon  containing the prophecies of St. Joh
Lady :: "A woman of social distinction or position. In England  a title prefixed to the name of any 
Palmaceous :: "Of or pertaining to palms; of the nature of  or resembling  palms."
Sand :: To sprinkle or cover with sand.
Alamort :: To the death; mortally.
Rhizostome :: One of the Rhizostomata.
Aerological :: Of or pertaining to aerology.
Unity :: The peculiar characteristics of an estate held by several in joint tenancy.
Water crowfoot :: "An aquatic kind of buttercup (Ranunculus aquatilis)  used as food for cattle in p
Robinet :: The European robin.
Unsalable :: Not salable; unmerchantable.
Nobleman :: "One of the nobility; a noble; a peer; one who enjoys rank above a commoner  either by v
Responsible :: "Liable to respond; likely to be called upon to answer; accountable; answerable; amen
Realities :: of Reality
Also :: In addition; besides; as well; further; too.
Pallid :: "Deficient in color; pale; wan; as  a pallid countenance; pallid blue."
Adrift :: Floating at random; in a drifting condition; at the mercy of wind and waves. Also fig.
Replaceable :: "Admitting of having its place supplied by a like thing or an equivalent; as  the los
Fubbery :: Cheating; deception.
Savagery :: "Wild growth  as of plants."
Fillet :: Any scantling smaller than a batten.
Ropewalk :: "A long  covered walk  or a low  level building  where ropes are manufactured."
Agitative :: Tending to agitate.
Jetsam :: Alt. of Jetson
Flitter :: To flutter.
Accentuate :: To pronounce with an accent or with accents.
Guaranies :: of Guaranty
Hare's-foot fern :: "A species of fern (Davallia Canariensis) with a soft  gray  hairy rootstock; --
Uncanny :: Not canny; unsafe; strange; weird; ghostly.
Verditer :: "Either one of two pigments (called blue verditer  and green verditer) which are made by
Fumatory :: See Fumitory.
Hard :: "Difficult to accomplish; full of obstacles; laborious; fatiguing; arduous; as  a hard task;
Neuter :: "An organism  either vegetable or animal  which at its maturity has no generative organs  
Forgone :: of Forgo
Reaffirm :: To affirm again.
Heathen :: "An individual of the pagan or unbelieving nations  or those which worship idols and do n
Vanfess :: "A ditch on the outside of the counterscarp  usually full of water."
Unclog :: "To disencumber of a clog  or of difficulties and obstructions; to free from encumbrances;
Leaseholder :: A tenant under a lease.
Fumarate :: A salt of fumaric acid.
Ragamuffin :: A person who wears ragged clothing.
Gate :: The channel or opening through which metal is poured into the mold; the ingate.
Admeasure :: The measure of a thing; dimensions; size.
Grindingly :: In a grinding manner.
Rodent :: Of or pertaining to the Rodentia.
Regent :: "One of a governing board; a trustee or overseer; a superintendent; a curator; as  the reg
Humane :: Pertaining to man; human.
Nucleal :: Alt. of Nuclear
Half-sighted :: Seeing imperfectly; having weak discernment.
Fresco :: "To paint in fresco  as walls."
Saturating :: of Saturate
Vertigo :: "Any one of numerous species of small land snails belonging to the genus Vertigo  having 
Absconded :: of Abscond
Rew :: A row.
Raindrop :: A drop of rain.
Recollect :: To recover or recall the knowledge of; to bring back to the mind or memory; to remember
Foreman :: "The chief man of a jury  who acts as their speaker."
Utopian :: "An inhabitant of Utopia; hence  one who believes in the perfectibility of human society;
Laurestine :: "The Viburnum Tinus  an evergreen shrub or tree of the south of Europe  which flowers 
Legislatorship :: The office of a legislator.
Yold :: of Yield
Galericu-late :: Covered as with a hat or cap.
Velate :: Having a veil; veiled.
Folding :: "The act of making a fold or folds; also  a fold; a doubling; a plication."
Juglans :: "A genus of valuable trees  including the true walnut of Europe  and the America black wa
Undertake :: To have knowledge of; to hear.
Rear :: "To bring up to maturity  as young; to educate; to instruct; to foster; as  to rear offsprin
Ahull :: "With the sails furled  and the helm lashed alee; -- applied to ships in a storm. See Hull 
Fabric :: "Any system or structure consisting of connected parts; as  the fabric of the universe."
Yewen :: "Made of yew; as  yewen bows."
Hypnotize :: To induce hypnotism in; to place in a state of hypnotism.
Key :: "A bar  pin or wedge  to secure a crank  pulley  coupling  etc.  upon a shaft  and prevent re
Fender :: "Anything set up to protect an exposed angle  as of a house  from damage by carriage wheel
Homologize :: To determine the homologies or structural relations of.
Saffron :: "The aromatic  pungent  dried stigmas  usually with part of the stile  of the Crocus sati
Renascible :: Capable of being reproduced; ablle to spring again into being.
Warfare :: Contest; struggle.
Fly :: The part of a vane pointing the direction from which the wind blows.
Ralstonite :: A fluoride of alumina and soda occurring with the Greenland cryolite in octahedral cry
After :: "Moving toward from behind; following  in search of; in pursuit of."
Schorl :: Black tourmaline.
Royal :: "One of the soldiers of the first regiment of foot of the British army  formerly called the
Rancid :: "Having a rank smell or taste  from chemical change or decomposition; musty; as  rancid oi
Gilbbery :: Slippery; changeable.
Scarn :: Dung.
Aloof :: Same as Alewife.
Redeposit :: To deposit again.
Macerating :: of Macerate
Lance fish :: "A slender marine fish of the genus Ammodytes  especially Ammodytes tobianus of the En
Afterguard :: "The seaman or seamen stationed on the poop or after part of the ship  to attend the a
Hooper :: "The European whistling  or wild  swan (Olor cygnus); -- called also hooper swan  whooping
Ibex :: "One of several species of wild goats having very large  recurved horns  transversely ridged
Gunter rig :: A topmast arranged with metal bands so that it will readily slide up and down the lowe
Gleek :: A jest or scoff; a trick or deception.
Rip :: A body of water made rough by the meeting of opposing tides or currents.
Gin :: "To clear of seeds by a machine; as  to gin cotton."
Hydrostatical :: "Of or relating to hydrostatics; pertaining to  or in accordance with  the principl
Far :: "A young pig  or a litter of pigs."
Helpful :: Furnishing help; giving aid; assistant; useful; salutary.
Hug :: "A close embrace or clasping with the arms  as in affection or in wrestling."
Pain :: "Any uneasy sensation in animal bodies  from slight uneasiness to extreme distress or tortur
Gorgoneion :: A mask carved in imitation of a Gorgon's head.
Graafian :: "Pertaining to  or discovered by  Regnier de Graaf  a Dutch physician."
Scutch :: The woody fiber of flax; the refuse of scutched flax.
Agush :: In a gushing state.
Adverbial :: "Of or pertaining to an adverb; of the nature of an adverb; as  an adverbial phrase or 
Geck :: "To cheat; trick  or gull."
Nitromuriatic :: "Of  pertaining to  or composed of  nitric acid and muriatic acid; nitrohydrochlori
Scaliness :: The state of being scaly; roughness.
Renunciatory :: "Pertaining to renunciation; containing or declaring a renunciation; as  renunciator
Franklin :: "An English freeholder  or substantial householder."
Rest :: "That on which anything rests or leans for support; as  a rest in a lathe  for supporting th
Salina period :: "The period in which the American Upper Silurian system  containing the brine-produ
Gote :: A channel for water.
Goose :: "A tailor's smoothing iron  so called from its handle  which resembles the neck of a goose.
Girl :: A young person of either sex; a child.
Graving :: of Grave
Us :: of I
Sea poker :: The lyrie.
Tailless :: Having no tail.
Underlie :: To lie below or under.
Sea louse :: "Any one of numerous species of isopod crustaceans of Cymothoa  Livoneca  and allied ge
Sacculus :: "A little sac; esp.  a part of the membranous labyrinth of the ear."
Hansard :: A merchant of one of the Hanse towns. See the Note under 2d Hanse.
Naturalize :: "To explain phenomena by natural agencies or laws  to the exclusion of the supernatura
Round :: "Having every portion of the surface or of the circumference equally distant from the cente
Undisposedness :: Indisposition; disinclination.
Verray :: Very; true.
Gnu :: "One of two species of large South African antelopes of the genus Catoblephas  having a mane 
Scraper :: "In the printing press  a board  or blade  the edge of which is made to rub over the tymp
Nearness :: The state or quality of being near; -- used in the various senses of the adjective.
Hyperbolist :: One who uses hyperboles.
Caddow :: A jackdaw.
Heronsew :: A heronshaw.
Undergrow :: Undergrown.
Grammaticism :: A point or principle of grammar.
Fuse :: To liquefy by heat; to render fiuid; to dissolve; to melt.
Gearing :: "The parts by which motion imparted to one portion of an engine or machine is transmitted
Fibril :: A small fiber; the branch of a fiber; a very slender thread; a fibrilla.
Nubile :: Of an age suitable for marriage; marriageable.
feuter :: "To set close; to fix in rest  as a spear."
Rank :: "To have a certain grade or degree of elevation in the orders of civil or military life; to 
Aiel :: See Ayle.
Abjection :: The act of bringing down or humbling.
Walker :: One who walks; a pedestrian.
Alleluia :: Alt. of Alleluiah
Helving :: of Helve
Needment :: Outfit; necessary luggage.
Grog :: "A mixture of spirit and water not sweetened; hence  any intoxicating liquor."
Narrowing :: The part of a stocking which is narrowed.
Obdurate :: "Hardened in feelings  esp. against moral or mollifying influences; unyielding; hard-hea
Alpaca :: "An animal of Peru (Lama paco)  having long  fine  wooly hair  supposed by some to be a do
Fosse :: A ditch or moat.
Hod :: "A kind of wooden tray with a handle  borne on the shoulder  for carrying mortar  brick  etc.
Uncontrovertibly :: Incontrovertibly.
Flag :: "A cloth usually bearing a device or devices and used to indicate nationality  party  etc.  
Unit :: A single thing or person.
Acanthopodious :: Having spinous petioles.
Glasseye :: A species of blindness in horses in which the eye is bright and the pupil dilated; a sor
Laurentian :: "Pertaining to  or near  the St. Lawrence River; as  the Laurentian hills."
Rise :: In various figurative senses.
Filler :: "One who  or that which  fills; something used for filling."
Flexural :: "Of  pertaining to  or resulting from  flexure; of the nature of  or characterized by  f
Geologian :: A geologist.
Remelt :: To melt again.
Rasse :: "A carnivore (Viverricula Mallaccensis) allied to the civet but smaller  native of China an
Forgotten :: of Forget
Youth :: of Youth
Flowerlessness :: State of being without flowers.
Unworth :: Unworthiness.
Laureating :: of Laureate
Back :: "Moving or operating backward; as  back action."
Gripe :: Grasp; seizure; fast hold; clutch.
Rounding :: "Modifying a speech sound by contraction of the lip opening; labializing; labialization.
Nebule :: A little cloud; a cloud.
Aerometry :: "The science of measuring the air  including the doctrine of its pressure  elasticity  
Unset :: Not set; not fixed or appointed.
Family :: "Honorable descent; noble or respectable stock; as  a man of family."
Scrabbling :: of Scrabble
Xanthophane :: The yellow pigment present in the inner segments of the retina in animals.  See Chrom
Fluke :: "An accidental and favorable stroke at billiards (called a scratch in the United States); h
Harlock :: Probably a corruption either of charlock or hardock.
Yeastiness :: "The quality or state of being yeasty  or frothy."
Remeve :: Alt. of Remewe
Housing :: The act of putting or receiving under shelter; the state of dwelling in a habitation.
Reflect :: "To throw back light  heat  or the like; to return rays or beams."
Adjutant :: A helper; an assistant.
Hack :: "A frame or grating of various kinds; as  a frame for drying bricks  fish  or cheese; a rack
Vassal :: To treat as a vassal; to subject to control; to enslave.
Handbill :: A pruning hook.
Fleet :: Swift in motion; moving with velocity; light and quick in going from place to place; nimble
Latescence :: A slight withdrawal from view or knowledge.
Frill :: "A ruffle  consisting of a fold of membrane  of hairs  or of feathers  around the neck of a
Finnish :: A Northern Turanian group of languages; the language of the Finns.
Halidom :: Holy doom; the Last Day.
Yllanraton :: The agouara.
Ferme :: "Rent for a farm; a farm; also  an abode; a place of residence; as  he let his land to ferm
Recover :: Recovery.
Hipps :: "See Hyp  n."
Nonaged :: Having the quality of nonage; being a minor; immature.
Paleocrinoidea :: A suborder of Crinoidea found chiefly in the Paleozoic rocks.
Greek :: "A native  or one of the people  of Greece; a Grecian; also  the language of Greece."
Fund :: "The stock of a national debt; public securities; evidences (stocks or bonds) of money lent 
Jockeying :: The act or management of one who jockeys; trickery.
Fickleness :: The quality of being fickle; instability; inconsonancy.
Ward :: "A projecting ridge of metal in the interior of a lock  to prevent the use of any key which 
Ahead :: In or to the front; in advance; onward.
Scherzando :: In a playful or sportive manner.
A :: "The first letter of the English and of many other alphabets. The capital A of the alphabets of
Ride :: A saddle horse.
Salivating :: of Salivate
Scrip :: "A preliminary certificate of a subscription to the capital of a bank  railroad  or other c
Horridness :: The quality of being horrid.
Sallied :: of Sally
Repositing :: of Reposit
Unweldy :: Unwieldy; unmanageable; clumsy.
Formulating :: of Formulate
Jib :: "To move restively backward or sidewise  -- said of a horse; to balk."
Unreproachable :: Not liable to be reproached; irreproachable.
Referendary :: "Formerly  an officer of state charged with the duty of procuring and dispatching dip
Unpleasant :: Not pleasant; not amiable or agreeable; displeasing; offensive.
Gormandizer :: "A greedy  voracious eater; a gormand; a glutton."
Gaunt :: "Attenuated  as with fasting or suffering; lean; meager; pinched and grim."
Rider :: A problem of more than usual difficulty added to another on an examination paper.
Velum :: "Curtain or covering; -- applied to various membranous partitions  especially to the soft p
Uncork :: "To draw the cork from; as  to uncork a bottle."
Hepatitis :: Inflammation of the liver.
Light-minded :: Unsettled; unsteady; volatile; not considerate.
Alluvion :: Matter deposited by an inundation or the action of flowing water; alluvium.
Absoluteness :: The quality of being absolute; independence of everything extraneous; unlimitedness;
Earnestness :: The state or quality of being earnest; intentness; anxiety.
Gladius :: "The internal shell  or pen  of cephalopods like the squids."
Hanch :: "A sudden fall or break  as the fall of the fife rail down to the gangway."
Vanglo :: "Benne (Sesamum orientale); also  its seeds; -- so called in the West Indies."
Unmoor :: To weigh anchor.
Gothicism :: Conformity to the Gothic style of architecture.
Unpeeled :: Not peeled.
Eccentric :: "In the Ptolemaic system  the supposed circular orbit of a planet about the earth  but 
Accensor :: One of the functionaries who light and trim the tapers.
Hoiden :: Rustic; rude; bold.
Necessitude :: Necessary connection or relation.
Scutibranchian :: One of the Scutibranchiata.
Rhabdophora :: An extinct division of Hydrozoa which includes the graptolities.
Warm-blooded :: "Having warm blood; -- applied especially to those animals  as birds and mammals  wh
Vapor :: Wind; flatulence.
Nerved :: "Having nerves of a special character; as  weak-nerved."
Latirostrous :: Having a broad beak.
Geographically :: In a geographical manner or method; according to geography.
Reveled :: of Revel
Abreast :: "Side by side; also  opposite; over against; on a line with the vessel's beam; -- with of
Ungual :: "Having a nail  claw  or hoof attached; -- said of certain bones of the feet."
Caduke :: Perishable; frail; transitory.
Calix :: A cup. See Calyx.
Rosier :: "A rosebush; roses  collectively."
Scorce :: Barter.
Gas :: Any irrespirable aeriform fluid.
Abstrusion :: The act of thrusting away.
Noggin :: A small mug or cup.
Alum shale :: "A variety of shale or clay slate  containing iron pyrites  the decomposition of which
Unaccurateness :: Inaccuracy.
Heterologous :: "Characterized by heterology; consisting of different elements  or of like elements 
Flocculent :: Applied to the down of newly hatched or unfledged birds.
Flanches :: of Flanch
Ride :: To be borne or in a fluid; to float; to lie.
Landowning :: Having property in land; of or pertaining to landowners.
Rather :: "Of two alternatives conceived of  this by preference to  or as more likely than  the othe
Flat :: "A level surface  without elevation  relief  or prominences; an extended plain; specifically
Faubourg :: "A suburb of French city; also  a district now within a city  but formerly without its w
Madrier :: "A plank to receive the mouth of a petard  with which it is applied to anything intended 
Remorsed :: Feeling remorse.
Rooftree :: "The beam in the angle of a roof; hence  the roof itself."
Albumenize :: "To cover or saturate with albumen; to coat or treat with an albuminous solution; as  
Unloosen :: To loosen; to unloose.
Fet :: A piece.
Haruspice :: A diviner of ancient Rome. Same as Aruspice.
Race :: "To run swiftly; to contend in a race; as  the animals raced over the ground; the ships race
Radiated :: "Formed of  or arranged like  rays or radii; having parts or markings diverging  like ra
Aberration :: "The act of wandering; deviation  especially from truth or moral rectitude  from the n
Unrecuring :: Incurable.
Hindrance :: That which hinders; an impediment.
Warty :: "Having warts; full of warts; overgrow with warts; as  a warty leaf."
Rub :: To spread a substance thinly over; to smear.
Akimbo :: With a crook or bend; with the hand on the hip and elbow turned outward.
Fricandeau :: Alt. of Fricando
Unreverend :: Not reverend.
Foretokened :: of Foretoken
Flounce :: "The act of floucing; a sudden  jerking motion of the body."
Foreman :: "The chief of a set of hands employed in a shop  or on works of any kind  who superintend
Rugged :: "Vigorous; robust; hardy; -- said of health  physique  etc."
Tagtail :: A worm which has its tail conspicuously colored.
Amazedness :: "The state of being amazed  or confounded with fear  surprise  or wonder."
Noils :: Waste and knots of wool removed by the comb; combings.
Fundus :: "The bottom or base of any hollow organ; as  the fundus of the bladder; the fundus of the 
Rawboned :: Having little flesh on the bones; gaunt.
Sardius :: "A precious stone  probably a carnelian  one of which was set in Aaron's breastplate."
Easel :: "A frame (commonly) of wood serving to hold a canvas upright  or nearly upright  for the pa
Froe :: An iron cleaver or splitting tool; a frow.
House :: "A structure intended or used as a habitation or shelter for animals of any kind; but espec
Eath :: Easy or easily.
Rut :: A track worn by a wheel or by habitual passage of anything; a groove in which anything runs. 
Friskal :: A leap or caper.
Fleshy :: Human.
Acanthaceous :: "Of  pertaining to  or resembling  the family of plants of which the acanthus is the
Rivage :: A duty paid to the crown for the passage of vessels on certain rivers.
Reecho :: "To echo back; to reverberate again; as  the hills reecho the roar of cannon."
Hymen :: A fold of muscous membrane often found at the orifice of the vagina; the vaginal membrane.
Sap :: To make unstable or infirm; to unsettle; to weaken.
Romantic :: "Of or pertaining to the style of the Christian and popular literature of the Middle Age
Cabiai :: The capybara. See Capybara.
Affuse :: To pour out or upon.
Valuable :: "Worthy; estimable; deserving esteem; as  a valuable friend; a valuable companion."
Ventricle :: The stomach.
Language :: "The forms of speech  or the methods of expressing ideas  peculiar to a particular natio
Upher :: "A fir pole of from four to seven inches diameter  and twenty to forty feet long  sometimes
Scragged :: Lean and rough; scraggy.
Flitting :: of Flit
Hernshaw :: Heronshaw.
Vernacularly :: In a vernacular manner; in the vernacular.
Headlong :: "Rash; precipitate; as  headlong folly."
Huckstress :: A female huckster.
Rancidly :: In a rancid manner.
Janizar :: A janizary.
Job :: To carry on the business of a jobber in merchandise or stocks.
Grindle :: The bowfin; -- called also Johnny Grindle.
Gelseminic :: "Pertaining to  or derived from  the yellow jasmine (Gelsemium sempervirens); as  gels
Glaive :: A sword; -- used poetically and loosely.
Form :: The combination of planes included under a general crystallographic symbol. It is not necess
Academist :: An Academic philosopher.
Ecclesiasticism :: "Strong attachment to ecclesiastical usages  forms  etc."
Lickerous :: Lickerish; eager; lustful.
Macle :: A crystal having a similar tessellated appearance.
Hecatomb :: "A sacrifice of a hundred oxen or cattle at the same time; hence  the sacrifice or slaug
Salvific :: Tending to save or secure safety.
Resignation :: "The act of resigning or giving up  as a claim  possession  office  or the like; surr
Achieved :: of Achieve
Hellish :: Of or pertaining to hell; like hell; infernal; malignant; wicked; detestable; diabolical.
Aboard :: Across; athwart.
Rundle :: "Something which rotates about an axis  as a wheel  or the drum of a capstan."
Glamourie :: Glamour.
Flaked :: of Flake
Untrowable :: Incredible.
Gnawed :: of Gnaw
Formality :: That which is formal; the formal part.
Jadeite :: "See Jade  the stone."
neighbor :: To associate intimately with.
Salad :: "A preparation of vegetables  as lettuce  celery  water cress  onions  etc.  usually dresse
Unitized :: of Unitize
Guide :: A grooved director for a probe or knife.
Gynandromorph :: "An animal affected with gynandromorphism "
Unwisely :: In an unwise manner; foolishly.
Representer :: A representative.
Scabble :: See Scapple.
Wair :: A piece of plank two yard/ long and a foot broad.
Vary :: "To change the aspect of; to alter in form  appearance  substance  position  or the like; to
Harsh :: "Having violent contrasts of color  or of light and shade; lacking in harmony."
Fermenting :: of Ferment
Hummer :: A humming bird.
Helminthagogue :: A vermifuge.
Rosalgar :: realgar.
Glue :: "A hard brittle brownish gelatin  obtained by boiling to a jelly the skins  hoofs  etc.  of 
Foolhardise :: Foolhardiness.
Unconstraint :: Freedom from constraint; ease.
Goblet :: "A kind of cup or drinking vessel having a foot or standard  but without a handle."
Urn :: A tea urn. See under Tea.
Alkalize :: To render alkaline; to communicate the properties of an alkali to.
Reprimer :: "A machine or implement for applying fresh primers to spent cartridge shells  so that th
Yield :: To give a reward to; to bless.
Remedy :: To apply a remedy to; to relieve; to cure; to heal; to repair; to redress; to correct; to 
Hydrazine :: "Any one of a series of nitrogenous bases  resembling the amines and produced by the re
Georgical :: Relating to agriculture and rural affairs.
Saccharum :: A genus of tall tropical grasses including the sugar cane.
Revival :: "Renewed prevalence of something  as a practice or a fashion."
Rancorously :: In a rancorous manner.
Rustle :: "To make a quick succession of small sounds  like the rubbing or moving of silk cloth or d
Re-create :: To create or form anew.
Gladeye :: The European yellow-hammer.
Ram :: To fill or compact by pounding or driving.
Hurl :: "To emit or utter with vehemence or impetuosity; as  to hurl charges or invective."
Resplendence :: Alt. of Resplendency
Administer :: "To manage or conduct  as public affairs; to direct or superintend the execution  appl
Yellow :: To make yellow; to cause to have a yellow tinge or color; to dye yellow.
Repetition :: "Reiteration  or repeating the same word  or the same sense in different words  for th
Hiss :: Any sound resembling that above described
Hartshorn :: Spirits of hartshorn (see below); volatile salts.
Fail :: "To deteriorate in respect to vigor  activity  resources  etc.; to become weaker; as  a sick
Houtou :: A beautiful South American motmot.
Faithful :: "Worthy of confidence and belief; conformable to truth ot fact; exact; accurate; as  a f
Oarfoot :: Any crustacean of the genus Remipes.
Retrieve :: To recall; to bring back.
Feather :: The fringe of long hair on the legs of the setter and some other dogs.
Leer :: The cheek.
Factor :: To resolve (a quantity) into its factors.
Redivide :: To divide anew.
Kenning :: "The limit of vision at sea  being a distance of about twenty miles."
Reedbird :: One of several small Asiatic singing birds of the genera Sch/nicola and Eurycercus; -- c
Hop :: "To gather hops. [Perhaps only in the form Hopping  vb. n.]"
Caballer :: One who cabals.
Fizzle :: A failure or abortive effort.
Forfeiting :: of Forfeit
Horse-leechery :: "The business of a farrier; especially  the art of curing the diseases of horses."
Water level :: The level formed by the surface of still water.
Hesperian :: Western; being in the west; occidental.
Huzzaed :: of Huzza
Easement :: "A curved member instead of an abrupt change of direction  as in a baseboard  hand rail 
Lapsing :: of Lapse
Rascaldom :: "State of being a rascal; rascality; domain of rascals; rascals  collectively."
Unseemly :: Not seemly; unbecoming; indecent.
Gopher :: "One of several North American burrowing rodents of the genera Geomys and Thomomys  of the
Baculite :: "A cephalopod of the extinct genus Baculites  found fossil in the Cretaceous rocks. It i
Unreally :: In an unreal manner; ideally.
Healthfulness :: The state of being healthful.
Scandal :: "Anything alleged in pleading which is impertinent  and is reproachful to any person  or 
Grisons :: The largest and most eastern of the Swiss cantons.
Hyp :: To make melancholy.
Read :: "To interpret; to explain; as  to read a riddle."
Jugular :: "Any fish which has the ventral fins situated forward of the pectoral fins  or beneath th
Last :: "Farthest of all from a given quality  character  or condition; most unlikely; having least 
Rough :: In a rough manner; rudely; roughly.
Unbend :: "To unfasten  as sails  from the spars or stays to which they are attached for use."
Rovingness :: The state of roving.
Vacillatory :: Inclined to vacillate; wavering; irresolute.
Xylic :: "Pertaining to  derived from  or related to  xylene; specifically  designating any one of s
Rhythmless :: Being without rhythm.
Water pore :: "One of certain minute pores in the leaves of some plants. They are without true guard
Ulcerating :: of Ulcerate
Noli-me-tangere :: "A name formerly applied to several varieties of ulcerous cutaneous diseases  but
Feasibilities :: of Feasibility
Fomentation :: Excitation; instigation; encouragement.
Rubidium :: "A rare metallic element. It occurs quite widely  but in small quantities  and always co
Safeguard :: To guard; to protect.
Ripe :: To mature; to ripen.
Zaerthe :: Same as Z/rthe.
Ustulation :: The roasting or drying of moist substances so as prepare them for pulverizing.
Waive :: "To throw away; to relinquish voluntarily  as a right which one may enforce if he chooses."
Acquit :: "To set free  release or discharge from an obligation  duty  liability  burden  or from an
Janthina :: See Ianthina.
Return :: To give in requital or recompense; to requite.
Flexion :: The act of flexing or bending; a turning.
Receive :: To bat back (the ball) when served.
Noblesse :: "The nobility; persons of noble rank collectively  including males and females."
Forerank :: The first rank; the front.
Runer :: "A bard  or learned man  among the ancient Goths."
Ruddle :: A riddle or sieve.
Accommodated :: of Accommodate
Hep :: "See Hip  the fruit of the dog-rose."
Ginshop :: A shop or barroom where gin is sold as a beverage.
Firedog :: A support for wood in a fireplace; an andiron.
Raker :: A person who uses a rake.
Hercynian :: "Of or pertaining to an extensive forest in Germany  of which there are still portions 
Sappy :: Abounding with sap; full of sap; juicy; succulent.
Xanthosis :: The yellow discoloration often observed in cancerous tumors.
Yarely :: In a yare manner.
Unefectual :: Ineffectual.
Harmonium :: "A musical instrument  resembling a small organ and especially designed for church musi
Halfcock :: To set the cock of (a firearm) at the first notch.
Viage :: A voyage; a journey.
Alp :: "Fig.: Something lofty  or massive  or very hard to be surmounted."
'Sblood :: An abbreviation of God's blood; -- used as an oath.
Footpad :: A highwayman or robber on foot.
Neologization :: The act or process of neologizing.
Paint :: "To form in colors a figure or likeness of on a flat surface  as upon canvas; to represent 
Reformade :: A reformado.
Raise :: "To cause (the land or any other object) to seem higher by drawing nearer to it; as  to rai
Sainted :: Consecrated; sacred; holy; pious.
Raise :: "To bring to a higher condition or situation; to elevate in rank  dignity  and the like; to
Unwrite :: "To cancel  as what is written; to erase."
Retract :: "To draw back; to draw up or shorten; as  the cat can retract its claws; to retract a mus
Nidulant :: "Nestling  as a bird in itss nest."
Rectify :: "To produce ( as factitious gin or brandy) by redistilling low wines or ardent spirits (w
Ajutage :: "A tube through which water is discharged; an efflux tube; as  the ajutage of a fountain.
Rage :: To toy or act wantonly; to sport.
Heyne :: A wretch; a rascal.
Gnathidium :: The ramus of the lower jaw of a bird as far as it is naked; -- commonly used in the pl
Satisfactory :: "Giving or producing satisfaction; yielding content; especially  relieving the mind 
Glycol :: "A thick  colorless liquid  C2H4(OH)2  of a sweetish taste  produced artificially from cer
Restrict :: Restricted.
Scuffler :: One who scuffles.
Kerchiefed :: Alt. of Kerchieft
Roam :: To go from place to place without any certain purpose or direction; to rove; to wander.
Raw :: "Not altered from its natural state; not prepared by the action of heat; as  raw sienna; spec
Hymenopter :: One of the Hymenoptera.
Callipers :: See Calipers.
Jellyfish :: "Any one of the acalephs  esp. one of the larger species  having a jellylike appearance
Acinose :: Alt. of Acinous
Fortunate :: "Receiving same unforeseen or unexpected good  or some good which was not dependent on 
Rankness :: The condition or quality of being rank.
Giglot :: Alt. of Giglet
Harmonist :: "One who shows the agreement or harmony of corresponding passages of different authors 
Urnfuls :: of Urnful
Unwedgeable :: Not to be split with wedges.
Funnelform :: "Having the form of a funnel  or tunnel; that is  expanding gradually from the bottom 
Rummager :: "A person on shipboard whose business was to take charge of stowing the cargo; -- former
Necrosis :: "Mortification or gangrene of bone  or the death of a bone or portion of a bone in mass 
Glimpsed :: of Glimpse
Unclench :: Same as Unclinch.
Scrophulariaceous :: "Of or pertaining to a very large natural order of gamopetalous plants (Scrophu
Fillet :: "The loins of a horse  beginning at the place where the hinder part of the saddle rests."
Fatiscence :: "A gaping or opening; state of being chinky  or having apertures."
Lesson :: To teach; to instruct.
Large :: "Crossing the line of a ship's course in a favorable direction; -- said of the wind when it
Yardland :: "A measure of land of uncertain quantity  varying from fifteen to forty acres; a virgate
Jobber :: "One who turns official or public business to private advantage; hence  one who performs l
Ruby :: "A precious stone of a carmine red color  sometimes verging to violet  or intermediate betwe
Waltz :: To dance a waltz.
Lapping :: A kind of machine blanket or wrapping material used by calico printers.
Field :: Any blank space or ground on which figures are drawn or projected.
Undiocesed :: Unprovided with a diocese; having no diocese.
Foreshower :: One who predicts.
Feateous :: Dexterous; neat.
Yet :: "Any one of several species of large marine gastropods belonging to the genus Yetus  or Cymba
Herd :: "To associate; to ally one's self with  or place one's self among  a group or company."
Levity :: "The quality of weighing less than something else of equal bulk; relative lightness  espec
Palindromist :: A writer of palindromes.
Valetudinarian :: A person of a weak or sickly constitution; one who is seeking to recover health.
Flourishingly :: In a flourishing manner; ostentatiously.
Calcaneal :: "Pertaining to the calcaneum; as  calcaneal arteries."
Ruling :: "Used in marking or engraving lines; as  a ruling machine or pen."
Gastrocolic :: "Pertaining to both the stomach and the colon; as  the gastrocolic  or great  omentum
Savor :: "Hence  specific flavor or quality; characteristic property; distinctive temper  tinge  tai
Vermiparous :: Producing or breeding worms.
Geranine :: A valuable astringent obtained from the root of the Geranium maculatum or crane's-bill.
Reliance :: "The act of relying  or the condition or quality of being reliant; dependence; confidenc
Uncircumstandtial :: Not circumstantial; not entering into minute particulars.
Screwed :: of Screw
Horny :: Hard; callous.
Reprehensible :: Worthy of reprehension; culpable; censurable; blamable.
Lexiphanic :: "Using  or interlarded with  pretentious words; bombastic; as  a lexiphanic writer or 
Reemergence :: Act of reemerging.
Rascally :: "Like a rascal; trickish or dishonest; base; worthless; -- often in humorous disparageme
Resentive :: Resentful.
Killigrew :: The Cornish chough. See under Chough.
Palatopterygoid :: "Pertaining to the palatine and pterygoid region of the skull; as  the palatopter
Unavoidable :: Not voidable; incapable of being made null or void.
Foreremembered :: Called to mind previously.
Nearing :: of Near
Yell :: "To cry out  or shriek  with a hideous noise; to cry or scream as with agony or horror."
Unconspicuous :: Inconspicuous.
Scrupulous :: "Careful; cautious; exact; nice; as  scrupulous abstinence from labor; scrupulous perf
Respectuous :: "Respectful; as  a respectuous silence."
Acknowledgment :: "The act of owning or recognized in a particular character or relationship; recogn
Unallied :: "Not allied; having no ally; having no connection or relation; as  unallied species or g
Unstop :: "To take the stopple or stopper from; as  to unstop a bottle or a cask."
Reciprocate :: To move forward and backward alternately; to recur in vicissitude; to act interchange
Advise :: "To take counsel; to consult; -- followed by with; as  to advise with friends."
Ebullience :: Alt. of Ebulliency
Rotten :: Offensive to the smell; fetid; disgusting.
Lasslorn :: Forsaken by a lass.
Heliopora :: An East Indian stony coral now known to belong to the Alcyonaria; -- called also blue c
Calabash :: The fruit of the calabash tree.
Generalship :: Military skill in a general officer or commander.
Judge :: To exercise the functions of a magistrate over; to govern.
Scutiger :: Any species of chilopod myriapods of the genus Scutigera. They sometimes enter buildings
Freehold :: "An estate in real property  of inheritance (in fee simple or fee tail) or for life; or 
Handsome :: Ample; moderately large.
Hasp :: An instrument for cutting the surface of grass land; a scarifier.
Heathenizing :: of Heathenize
Hyetal :: "Of or pertaining to rain; descriptive of the distribution of rain  or of rainy regions."
Hungerer :: One who hungers; one who longs.
Gonydial :: Pertaining to the gonys of a bird's beak.
Lapidary :: "An artificer who cuts  polishes  and engraves precious stones; hence  a dealer in preci
Foiler :: One who foils or frustrates.
Hermogenian :: "A disciple of Hermogenes  an heretical teacher who lived in Africa near the close of
Vent :: Fig.: Opportunity of escape or passage from confinement or privacy; outlet.
Ailanthus :: Same as Ailantus.
Alkargen :: Same as Cacodylic acid.
Notice :: "To treat with attention and civility; as  to notice strangers."
Alman :: The German language.
Scraggedness :: Quality or state of being scragged.
Rosedrop :: A kind of earring.
Groin :: To grunt to growl; to snarl; to murmur.
Gnash :: "To strike together  as in anger or pain; as  to gnash the teeth."
Reviving :: Returning or restoring to life or vigor; reanimating.
Frigidness :: "The state of being frigid; want of heat  vigor  or affection; coldness; dullness."
Galloping :: "Going at a gallop; progressing rapidly; as  a galloping horse."
Rumble :: A noisy report; rumor.
Schooling :: Collecting or running in schools or shoals.
Unskill :: Want of skill; ignorance; unskillfulness.
Fireback :: "One of several species of pheasants of the genus Euplocamus  having the lower back a br
Forte :: The strong point; that in which one excels.
Adorement :: The act of adoring; adoration.
Agency :: "The office of an agent  or factor; the relation between a principal and his agent; busine
Callosities :: of Callosity
Allantoid :: "A membranous appendage of the embryos of mammals  birds  and reptiles  -- in mammals s
Glance :: An incidental or passing thought or allusion.
Lawe :: "To cut off the claws and balls of  as of a dog's fore feet."
Uniaxial :: Having only one axis; developing along a single line or plane; -- opposed to multiaxial.
Heartburning :: Same as Heartburn.
Heminae :: of Hemina
Factor :: "One of the elements  circumstances  or influences which contribute to produce a result; a
Scorious :: Scoriaceous.
Waling :: "Same as Wale  n.  4."
Fringed :: of Fringe
Finlike :: Resembling a fin.
Factorial :: Related to factorials.
Rafter :: "To make into rafters  as timber."
Gim :: Neat; spruce.
Gowk :: A simpleton; a gawk or gawky.
Nonsense :: Trifles; things of no importance.
Calling :: "The persons  collectively  engaged in any particular professions or employment."
Acolyctine :: "An organic base  in the form of a white powder  obtained from Aconitum lycoctonum."
Latin :: "Of  pertaining to  or composed in  the language used by the Romans or Latins; as  a Latin 
Nototherium :: "An extinct genus of gigantic herbivorous marsupials  found in the Pliocene formation
Folium :: "A leaf  esp. a thin leaf or plate."
Fitment :: The act of fitting; that which is proper or becoming; equipment.
Ripple :: "a small wave on the surface of water or other liquids for which the driving force is not 
Ninth :: The quotient of one divided by nine; one of nine equal parts of a thing; the next after the
Victim :: "A living being sacrificed to some deity  or in the performance of a religious rite; a cre
Honorableness :: "Conformity to the principles of honor  probity  or moral rectitude; fairness; upri
Hellbred :: Produced in hell.
Ridgebone :: The backbone.
Hunt :: To follow the chase; to go out in pursuit of game; to course with hounds.
Fopling :: A petty fop.
Saddlebow :: "The bow or arch in the front part of a saddle  or the pieces which form the front."
Gambist :: A performer upon the viola di gamba. See under Viola.
Fain :: Well-pleased; glad; apt; wont; fond; inclined.
Gnarly :: Full of knots; knotty; twisted; crossgrained.
Rhodonite :: "Manganese spar  or silicate of manganese  a mineral occuring crystallised and in rose-
Rondle :: A rondeau.
Replum :: "The framework of some pods  as the cress  which remains after the valves drop off."
Hatch :: To cross with lines in a peculiar manner in drawing and engraving. See Hatching.
Feathery :: "Pertaining to  or resembling  feathers; covered with  or as with  feathers; as  feather
Algorism :: Alt. of Algorithm
Hurl :: Tumult; riot; hurly-burly.
Rubricist :: "One skilled in  or tenaciously adhering to  the rubric or rubrics."
Farcy :: "A contagious disease of horses  associated with painful ulcerating enlargements  esp. upon
Hendiadys :: "A figure in which the idea is expressed by two nouns connected by and  instead of by a
Addle-brain :: Alt. of Addle-pate
Greave :: Armor for the leg below the knee; -- usually in the plural.
Acrotomous :: Having a cleavage parallel with the base.
Calker :: "A calk on a shoe. See Calk  n.  1."
Roller :: Any species of small ground snakes of the family Tortricidae.
Saltatorious :: "Capable of leaping; formed for leaping; saltatory; as  a saltatorious insect or leg
Upbind :: To bind up.
Scission :: The act of dividing with an instrument having a sharp edge.
Raddle :: To interweave or twist together.
Sea elephant :: "A very large seal (Macrorhinus proboscideus) of the Antarctic seas  much hunted for
Reperception :: The act of perceiving again; a repeated perception of the same object.
Tabid :: Affected by tabes; tabetic.
Kendal green :: Alt. of Kendal
Naphthalenic :: "Pertaining to   or derived from  naphthalene; -- used specifically to designate a y
Aborted :: "Rendered abortive or sterile; undeveloped; checked in normal development at a very early
Riches :: "That which appears rich  sumptuous  precious  or the like."
Babied :: of Baby
Ruralist :: One who leads a rural life.
Repealment :: "Recall  as from banishment."
Revert :: To return; to come back.
Heterotricha :: "A division of ciliated Infusoria  having fine cilia all over the body  and a circle
Schrode :: See Scrod.
Garrote :: "To strangle with the garrote; hence  to seize by the throat  from behind  with a view to
Fore :: Journey; way; method of proceeding.
Abbreviate :: An abridgment.
Lamb :: "To bring forth a lamb or lambs  as sheep."
Fuchs :: A student of the first year.
Health :: "A wish of health and happiness  as in pledging a person in a toast."
Reciprocal :: "The quotient arising from dividing unity by any quantity; thus  / is the reciprocal o
Upseek :: To seek or strain upward.
Hewhole :: The European green woodpecker. See Yaffle.
Gnat :: "A blood-sucking dipterous fly  of the genus Culex  undergoing a metamorphosis in water. The
Fewness :: The state of being few; smallness of number; paucity.
Hobble :: To perplex; to embarrass.
Abbreviator :: "One of a college of seventy-two officers of the papal court whose duty is to make a 
Netify :: To render neat; to clean; to put in order.
Admonishing :: of Admonish
Hearties :: of Hearty
Abraded :: of Abrade
Groats :: "Dried grain  as oats or wheat  hulled and broken or crushed; in high milling  cracked fra
Laminaria :: "A genus of great seaweeds with long and broad fronds; kelp  or devil's apron. The fron
Glimpse :: A faint idea; an inkling.
Earnest :: "Something given  or a part paid beforehand  as a pledge; pledge; handsel; a token of wha
Pallet :: A potter's wheel.
Justice :: To administer justice to.
Lambskin :: A kind of woolen.
High :: The highest card dealt or drawn.
Retain :: "To keep in pay; to employ by a preliminary fee paid; to hire; to engage; as  to retain a 
Sailboat :: A boat propelled by a sail or sails.
Value :: Valor.
Fashionable :: "Genteel; well-bred; as  fashionable society."
Gossiping :: of Gossip
Legion :: A military force; an army; military bands.
Wantoned :: of Wanton
Roll :: "To fall or tumble; -- with over; as  a stream rolls over a precipice."
Rewme :: Realm.
Tagsore :: Adhesion of the tail of a sheep to the wool from excoriation produced by contact with the
Agrimony :: A genus of plants of the Rose family.
Absolutistic :: Pertaining to absolutism; absolutist.
Rushlight :: "A rush candle  or its light; hence  a small  feeble light."
Aerial :: Light as air; ethereal.
Roundly :: Briskly; with speed.
Glebeless :: Having no glebe.
Frambaesia :: The yaws. See Yaws.
Guardable :: Capable of being guarded or protected.
Headsman :: An executioner who cuts off heads.
Nephalism :: Total abstinence from spirituous liquor.
Rancorous :: "Full of rancor; evincing  or caused by  rancor; deeply malignant; implacably spiteful 
Jehovist :: "One who maintains that the vowel points of the word Jehovah  in Hebrew  are the proper 
Golde :: Alt. of Goolde
Affix :: To fix or fasten in any way; to attach physically.
Scoff :: To show insolent ridicule or mockery; to manifest contempt by derisive acts or language; --
Fault :: A dislocation of the strata of the vein.
Laconic :: Alt. of Laconical
Vettura :: "An Italian four-wheeled carriage  esp. one let for hire; a hackney coach."
Calmer :: "One who  or that which  makes calm."
Nightingale :: "A small  plain  brown and gray European song bird (Luscinia luscinia). It sings at n
Early :: "Soon; in good season; seasonably; betimes; as  come early."
Wagon-headed :: "Having a top  or head  shaped like the top of a covered wagon  or resembling in sec
Frost-bitten :: "Nipped  withered  or injured  by frost or freezing."
Humane :: Having the feelings and inclinations creditable to man; having a disposition to treat othe
Right :: To recover the proper or natural condition or position; to become upright.
Pactional :: "Of the nature of  or by means of  a paction."
Fox-hunting :: Pertaining to or engaged in the hunting of foxes; fond of hunting foxes.
Grieve :: "To feel grief; to be in pain of mind on account of an evil; to sorrow; to mourn; -- often
Jog :: "To move by jogs or small shocks  like those of a slow trot; to move slowly  leisurely  or mo
Urodele :: One of the Urodela.
Holophytic :: Wholly or distinctively vegetable.
Homologous :: Corresponding in relative position and proportion.
Hiccoughing :: of Hiccough
Scheme :: "A plan or theory something to be done; a design; a project; as  to form a scheme."
Hardspun :: Firmly twisted in spinning.
Fumify :: To subject to the action of smoke.
Reconnaissance :: An examination or survey of a region in reference to its general geological charac
Roseroot :: A fleshy-leaved herb (Rhodiola rosea); rosewort; -- so called because the roots have the
Lapse :: A fall or apostasy.
Uxoricidal :: Of or pertaining to uxoricide; tending to uxoricide.
Hawed :: of Haw
Uvate :: A conserve made of grapes.
Hyperbola :: "A curve formed by a section of a cone  when the cutting plane makes a greater angle wi
Rhamphothecae :: of Rhamphotheca
Underpoise :: "To weigh  estimate  or rate below desert; to undervalue."
Paleology :: "The study or knowledge of antiquities  esp. of prehistoric antiquities; a discourse or
Recoinage :: The act of coining anew.
Hendecasyllabic :: Pertaining to a line of eleven syllables.
Aciurgy :: Operative surgery.
Glyphic :: "Of or pertaining to sculpture or carving of any sort  esp. to glyphs."
Unbenign :: Not benign; malignant.
Afformative :: An affix.
Hygrology :: The science which treats of the fluids of the body.
Addressee :: One to whom anything is addressed.
Yumas :: "A tribe of Indians native of Arizona and the adjacent parts of Mexico and California. They
Paleobotany :: That branch of paleontology which treats of fossil plants.
Heer :: Hair.
Generated :: of Generate
Regency :: The office of ruler; rule; authority; government.
Factory :: "A building  or collection of buildings  appropriated to the manufacture of goods; the pl
Abaft :: "Behind; toward the stern from; as  abaft the wheelhouse."
Lest :: That (without the negative particle); -- after certain expressions denoting fear or apprehen
Uriniparous :: "Producing or preparing urine; as  the uriniparous tubes in the cortical portion of t
Unpolitic :: Impolitic; imprudent.
Unnature :: To change the nature of; to invest with a different or contrary nature.
Wall :: "An inclosing part of a receptacle or vessel; as  the walls of a steam-engine cylinder."
Aleconner :: "Orig.  an officer appointed to look to the goodness of ale and beer; also  one of the 
Guttiform :: "Drop-shaped  as a spot of color."
Grot :: Alt. of Grote
Undispensable :: Indispensable.
Adversarious :: Hostile.
Lifen :: To enliven.
Adjudication :: A process by which land is attached security or in satisfaction of a debt.
Abstract :: An abstract term.
Hippophagous :: "Feeding on horseflesh; -- said of certain nomadic tribes  as the Tartars."
Nonprofessional :: "Not belonging to a profession; not done by  or proceeding from  professional men
Saxifraga :: "A genus of exogenous polypetalous plants  embracing about one hundred and eighty speci
Glaum :: "To grope with the hands  as in the dark."
Hymnography :: The art or act of composing hymns.
Restant :: Persistent.
Calciform :: In the form of chalk or lime.
Receive :: To admit; to take in; to hold; to contain; to have capacity for; to be able to take in.
Sacked :: of Sack
Gingerness :: Cautiousness; tenderness.
Lento :: Slow; in slow time; slowly; -- rarely written lente.
Fortin :: A little fort; a fortlet.
Yodeled :: of Yodle
Harmonicon :: "A small  flat  wind instrument of music  in which the notes are produced by the vibra
Florence :: "An ancient gold coin of the time of Edward III.  of six shillings sterling value."
Lactifical :: Producing or yielding milk.
Upsoar :: To soar or mount up.
Light :: Easily bestowed; inconsiderately rendered.
Scarecrow :: A person clad in rags and tatters.
Retarded :: of Retard
Jounced :: of Jounce
Watering :: of Water
Retrench :: "To furnish with a retrenchment; as  to retrench bastions."
Royalist :: "An adherent of a king (as of Charles I. in England  or of the Bourbons in france); one 
Gemma :: "A leaf bud  as distinguished from a flower bud."
Palet :: "A perpendicular band upon an escutcheon  one half the breadth of the pale."
Racer :: "One who  or that which  races  or contends in a race; esp.  a race horse."
Hallucination :: "The perception of objects which have no reality  or of sensations which have no co
Finns :: Natives of Finland; Finlanders.
Restorable :: "Admitting of being restored; capable of being reclaimed; as  restorable land."
Flinched :: of Flinch
Hurlwind :: A whirlwind.
Reverence :: "Profound respect and esteem mingled with fear and affection  as for a holy being or pl
Pabulation :: Food; fodder; pabulum.
Rhetian :: "Pertaining to the ancient Rhaeti  or Rhaetians  or to Rhaetia  their country; as  the Rh
Fresh :: "Not salt; as  fresh water  in distinction from that which is from the sea  or brackish; fr
Abstemiousness :: "The quality of being abstemious  temperate  or sparing in the use of food and str
Nib :: "One of the handles which project from a scythe snath; also  [Prov. Eng.]  the shaft of a wag
Greenback :: "One of the legal tender notes of the United States; -- first issued in 1862  and havin
Raisonne :: "Arranged systematically  or according to classes or subjects; as  a catalogue raisonne.
Yearn :: To pain; to grieve; to vex.
Flashing :: "Pieces of metal  built into the joints of a wall  so as to lap over the edge of the gut
Warble :: To utter musically; to modulate; to carol.
Screamed :: of Scream
Affirmation :: "That which is asserted; an assertion; a positive statement; an averment; as  an affi
Actable :: Capable of being acted.
Ferine :: A wild beast; a beast of prey.
Rivalry :: "The act of rivaling  or the state of being a rival; a competition."
Sally :: An excursion from the usual track; range; digression; deviation.
Sanctimonious :: Possessing sanctimony; holy; sacred; saintly.
Lashing :: See 2d Lasher.
Guanacos :: of Guanaco
Glee :: An unaccompanied part song for three or more solo voices. It is not necessarily gleesome.
Heygh :: High.
Ground :: "A gummy composition spread over the surface of a metal to be etched  to prevent the acid 
Gripe :: Pinching and spasmodic pain in the intestines; -- chiefly used in the plural.
Agistment :: The price paid for such feeding.
Hypaethral :: Alt. of Hypethral
Tabernacle :: "Hence  a work of art of sacred subject  having a partially architectural character  a
Samson :: "An Israelite of Bible record (see Judges xiii.)  distinguished for his great strength; he
Unleavened :: "Not leavened; containing no leaven; as  unleavened bread."
Fosset :: A faucet.
Florence :: A kind of cloth.
Aftermath :: A second moving; the grass which grows after the first crop of hay in the same season; 
Gladiatorian :: "Of or pertaining to gladiators  or to contests or combatants in general."
Ailantus :: "A genus of beautiful trees  natives of the East Indies. The tree imperfectly di/cious  
Faculty :: Special mental endowment; characteristic knack.
Roller :: ANy insect whose larva rolls up leaves; a leaf roller. see Tortrix.
Nitty :: Shining; elegant; spruce.
Scamp :: A rascal; a swindler; a rogue.
Fulfilling :: of Fulfill
Vassaless :: A female vassal.
Ripler :: Alt. of Ripper
Flatterer :: One who flatters.
Nihilist :: "One who advocates the doctrine of nihilism; one who believes or teaches that nothing ca
Fearfully :: In a fearful manner.
Umpireship :: Umpirage; arbitrament.
Noxious :: "Hurtful; harmful; baneful; pernicious; injurious; destructive; unwholesome; insalubrious
Notelet :: A little or short note; a billet.
Wadset :: A kind of pledge or mortgage.
Undershoot :: To shoot short of (a mark).
Screw :: "To turn one's self uneasily with a twisting motion; as  he screws about in his chair."
Undersetting :: Something set or built under as a support; a pedestal.
Hoy :: Ho! Halloe! Stop!
Halves :: of Half
Sashed :: of Sash
Hyperorganic :: "Higher than  or beyond the sphere of  the organic."
Ramage :: Wild; untamed.
Garish :: Showy; dazzling; ostentatious; attracting or exciting attention.
Rajahship :: The office or dignity of a rajah.
Jentling :: A fish of the genus Leuciscus; the blue chub of the Danube.
Abbacy :: "The dignity  estate  or jurisdiction of an abbot."
Unboweling :: of Unbowel
Veinous :: Marked with veins; veined; veiny.
Unreverently :: Irreverently.
Fluor albus :: The whites; leucorrhaea.
Adducer :: One who adduces.
Rejoin :: To answer to a reply.
Scintillate :: "To emit sparks  or fine igneous particles."
Tableau :: A striking and vivid representation; a picture.
Reaved :: of Reave
Rache :: "A dog that pursued his prey by scent  as distinguished from the greyhound."
Act :: "That which is done or doing; the exercise of power  or the effect  of which power exerted is
Figary :: A frolic; a vagary; a whim.
Uncheckable :: Not capable of being checked or stopped.
Leucoryx :: "A large antelope of North Africa (Oryx leucoryx)  allied to the gemsbok."
Hem :: "To make the sound expressed by the word hem; hence  to hesitate in speaking."
Sceptical :: Alt. of Scepticism
Vexatious :: "Full or vexation  trouble  or disquiet; disturbed."
Familiarity :: "Anything said or done by one person to another unceremoniously and without constrain
Hyloist :: Same as Hylotheist.
Refrigerant :: Cooling; allaying heat or fever.
Warbling :: of Warble
Fork :: "Anything furcate or like a fork in shape  or furcate at the extremity; as  a tuning fork."
Glossitis :: Inflammation of the tongue.
Reason :: "Hence: To carry on a process of deduction or of induction  in order to convince or to con
Leering :: of Leer
Undertime :: The under or after part of the day; undermeal; evening.
Waning :: of Wane
Recruited :: of Recruit
Verge :: "To tend downward; to bend; to slope; as  a hill verges to the north."
Paleothere :: Any species of Paleotherium.
Labrums :: of Labrum
Heard :: of Hear
Let :: To leave; to relinquish; to abandon.
Flemer :: "One who  or that which  banishes or expels."
Hectogramme :: The same as Hectogram.
Nonappearance :: "Default of apperance  as in court  to prosecute or defend; failure to appear."
Remark :: "To express in words or writing  as observed or noticed; to state; to say; -- often with a
Abye :: To pay for; to suffer for; to atone for; to make amends for; to give satisfaction.
Reverted :: of Revert
Floyte :: A variant of Flute.
Forwrap :: To wrap up; to conceal.
Gybe :: See Jib.
Ungka :: The siamang; -- called also ungka ape.
Gelatinate :: "To be converted into gelatin  or into a substance like jelly."
Garden :: To lay out or cultivate a garden; to labor in a garden; to practice horticulture.
Scratch :: "Minute  but tender and troublesome  excoriations  covered with scabs  upon the heels of 
Sanious :: "Discharging sanies; as  a sanious ulcer."
Renascent :: "Springing or rising again into being; being born again  or reproduced."
Fielded :: Engaged in the field; encamped.
Gradient :: "Adapted for walking  as the feet of certain birds."
Lift :: "A lift gate. See Lift gate  below."
Gross :: "Expressing  Or originating in  animal or sensual appetites; hence  coarse  vulgar  low  ob
Saliva :: The secretion from the salivary glands.
Librettos :: of Libretto
Horse :: A jackstay.
Joll :: Same as Jowl.
Hyparterial :: Situated below an artery; applied esp. to the branches of the bronchi given off below
Urethra :: The canal by which the urine is conducted from the bladder and discharged.
Gorma :: The European cormorant.
Adorn :: To deck or dress with ornaments; to embellish; to set off to advantage; to render pleasing 
Nictate :: To wink; to nictitate.
Rheinberry :: "One of the berries or drupes of the European buckthorn; also  the buckthorn itself."
Face :: Ten degrees in extent of a sign of the zodiac.
Faintly :: "In a faint  weak  or timidmanner."
Homography :: "That method of spelling in which every sound is represented by a single character  wh
Yodle :: "A song sung by yodeling  as by the Swiss mountaineers."
Unhorse :: "To throw from a horse; to cause to dismount; also  to take a horse or horses from; as  t
Alar :: Axillary; in the fork or axil.
Rioter :: "One who engages in a riot. See Riot  n.  3."
Keyway :: "See Key way  under Key."
Hand :: To cooperate.
Calcareo-argillaceous :: "consisting of  or containing  calcareous and argillaceous earths."
Agent :: "One who acts for  or in the place of  another  by authority from him; one intrusted with t
Agnail :: "An inflammation or sore under or around the nail; also  a hangnail."
Unbefool :: To deliver from the state of a fool; to awaken the mind of; to undeceive.
Radical :: "A primitive word; a radix  root  or simple  underived  uncompounded word; an etymon."
Granatite :: See Staurolite.
Hygienics :: The science of health; hygiene.
Formalist :: "One overattentive to forms  or too much confined to them; esp.  one who rests in exter
Lamish :: Somewhat lame.
Unmagistrate :: To divest of the office or authority of a magistrate.
Lapsided :: See Lopsided.
Filter :: "To purify or defecate  as water or other liquid  by causing it to pass through a filter."
Graphology :: "The art of judging of a person's character  disposition  and aptitude from his handwr
Nobody :: A person of no influence or importance; an insignificant or contemptible person.
Rabble :: "To stir or skim with a rabble  as molten iron."
Nothing :: Not anything; no thing (in the widest sense of the word thing); -- opposed to anything an
Review :: A lesson studied or recited for a second time.
Joggling :: of Joggle
Adamant :: Lodestone; magnet.
Herma :: "See Hermes  2."
Lancinating :: of Lanciname
Seamanship :: "The skill of a good seaman; the art  or skill in the art  of working a ship."
Accessible :: "Easy of access or approach; approachable; as  an accessible town or mountain  an acce
Gonorrhoeal :: "Of or pertaining to gonorrhea; as  gonorrheal rheumatism."
Hand :: "A measure equal to a hand's breadth  -- four inches; a palm. Chiefly used in measuring the 
Hispanic :: "Of or pertaining to Spain or its language; as  Hispanic words."
Hyoglossal :: "Pertaining to or connecting the tongue and hyodean arch; as  the hyoglossal membrane.
Unbag :: "To pour  or take  or let go  out of a bag or bags."
Scabbard plane :: "See Scaleboard plane  under Scaleboard."
Graceless :: "Wanting in grace or excellence; departed from  or deprived of  divine grace; hence  de
Fly :: "Two or more vanes set on a revolving axis  to act as a fanner  or to equalize or impede the 
Kex :: A dry husk or covering.
Northwards :: "Toward the north  or toward a point nearer to the north than to the east or west poin
Roadster :: One who drives much; a coach driver.
Founder :: "To cause internal inflammation and soreness in the feet or limbs of (a horse)  so as to 
Nebular :: "Of or pertaining to nebulae; of the nature of  or resembling  a nebula."
Glomerating :: of Glomerate
Glimmer :: "A faint  unsteady light; feeble  scattered rays of light; also  a gleam."
Vendible :: "Something to be sold  or offered for sale."
Scoley :: To go to school; to study.
Founder :: "To fall; to stumble and go lame  as a horse."
Accuse :: "To charge with  or declare to have committed  a crime or offense"
-uret :: A suffix with the same meaning as -ide. See -ide.
Neuropteris :: "An extensive genus of fossil ferns  of which species have been found from the Devoni
Gisle :: A pledge.
Refashion :: To fashion anew; to form or mold into shape a second time.
Rostrums :: of Rostrum
Harlot :: "A churl; a common man; a person  male or female  of low birth."
Remorseful :: Exciting pity; pitiable.
Lardon :: Alt. of Lardoon
Scintilla :: A spark; the least particle; an iota; a tittle.
Gemmuliferous :: Bearing or producing gemmules or buds.
Flammability :: The quality of being flammable; inflammability.
Flindermouse :: A bat; a flittermouse.
Vane :: "A contrivance attached to some elevated object for the purpose of showing which way the win
Verderor :: "An officer who has the charge of the king's forest  to preserve the vert and venison  k
Junker :: "A young German noble or squire; esp.  a member of the aristocratic party in Prussia."
Frozen :: Cold-hearted; unsympathetic; unyielding.
Sauce :: Sauciness; impertinence.
Guacho :: An Indian who serves as a messenger.
Untrue :: Untruly.
Great-grandmother :: The mother of one's grandfather or grandmother.
Hoopoe :: Alt. of Hoopoo
Umpire :: "To decide as umpire; to arbitrate; to settle  as a dispute."
Watermark :: "See Water line  2."
Journalism :: The keeping of a journal or diary.
Recipes :: of Recipe
Nomen :: of Nim
Air :: Utterance abroad; publicity; vent.
Haven :: A place of safety; a shelter; an asylum.
Feeze :: Fretful excitement. [Obs.] See Feaze.
Saciety :: Satiety.
Gourmand :: A greedy or ravenous eater; a glutton. See Gormand.
Accredit :: "To credit; to vouch for or consider (some one) as doing something  or (something) as be
Hydrotropic :: "Turning or bending towards moisture  as roots."
Gentrie :: Nobility of birth or of character; gentility.
Horsefish :: The moonfish (Selene setipinnis).
Reply :: "That which is said  written  or done in answer to what is said  written  or done by anothe
Glairy :: "Like glair  or partaking of its qualities; covered with glair; viscous and transparent; s
Upskip :: An upstart.
Foresay :: To foretell.
Renverse :: To reverse.
Adrogate :: To adopt (a person who is his own master).
Recognizance :: "An obligation of record entered into before some court of record or magistrate duly
Hotfoot :: In haste; foothot.
Rude :: "Violent; tumultuous; boisterous; inclement; harsh; severe; -- said of the weather  of storm
Froth :: "Light  unsubstantial matter."
Ye :: "an old method of printing the article the (AS.  /e)  the ""y"" being used in place of the Ang
Earn :: "See Ern  n."
Freedom :: The state of being free; exemption from the power and control of another; liberty; indepe
Heathenry :: "The state  quality  or character of the heathen."
Horn-mad :: Quite mad; -- raving crazy.
Calomel :: "Mild chloride of mercury  Hg2Cl2  a heavy  white or yellowish white substance  insoluble
Unregeneracy :: The quality or state of being unregenerate.
Unicorn :: A howitzer.
Juncture :: "A point of time; esp.  one made critical or important by a concurrence of circumstances
Hatch :: "An opening in the deck of a vessel or floor of a warehouse which serves as a passageway or
Romany :: The language spoken among themselves by the gypsies.
Address :: "To direct  as words (to any one or any thing); to make  as a speech  petition  etc. (to 
Ruminating :: of Ruminate
Wagonage :: Money paid for carriage or conveyance in wagon.
Urinate :: To discharge urine; to make water.
Agnus castus :: A species of Vitex (V. agnus castus); the chaste tree.
Gorebill :: The garfish.
Advocateship :: Office or duty of an advocate.
Adversely :: In an adverse manner; inimically; unfortunately; contrariwise.
Unappealable :: "Not appealable; that can not be carried to a higher tribunal by appeal; as  an unap
Noon :: The middle of the day; midday; the time when the sun is in the meridian; twelve o'clock in t
Paean :: "An ancient Greek hymn in honor of Apollo as a healing deity  and  later  a song addressed 
Remedying :: of Remedy
Utopical :: Utopian; ideal.
Regeneration :: "The reproduction of a part which has been removed or destroyed; re-formation; -- a 
Hile :: To hide. See Hele.
Furfuration :: Falling of scurf from the head; desquamation.
Neuroskeleton :: The deep-seated parts of the vertebrate skeleton which are relation with the nervou
Back :: "The outward or upper part of a thing  as opposed to the inner or lower part; as  the back o
Sabaism :: See Sabianism.
Refocillation :: Restoration of strength by refreshment.
Reassume :: To assume again or anew; to resume.
Vexillary :: A standard bearer.
Neuralgic :: "Of or pertaining to  or having the character of  neuralgia; as  a neuralgic headache."
Herbose :: Alt. of Herbous
Farcical :: "Of or pertaining to the disease called farcy. See Farcy  n."
Unballasted :: "Not furnished with ballast; not kept steady by ballast; unsteady; as  unballasted ve
Cadew :: Alt. of Cadeworm
Juvenile :: "Young; youthful; as  a juvenile appearance."
Tailboard :: "The board at the rear end of a cart or wagon  which can be removed or let down  for co
Vibroscope :: An instrument for observing or tracing vibrations.
Fergusonite :: "A mineral of a brownish black color  essentially a tantalo-niobate of yttrium  erbiu
Scantlet :: A small pattern; a small quantity.
Jolly :: "Expressing mirth  or inspiring it; exciting mirth and gayety."
Recessive :: Going back; receding.
Feme :: A woman.
Recognizee :: The person in whose favor a recognizance is made.
Heart :: To give heart to; to hearten; to encourage; to inspirit.
Vibriones :: of Vibrio
Unnatural :: "Not natural; contrary  or not conforming  to the order of nature; being without natura
Gazement :: View.
Foreground :: "On a painting  and sometimes in a bas-relief  mosaic picture  or the like  that part 
Nare :: A nostril.
Undertaker :: "Specifically  one who takes the charge and management of funerals."
Respect :: To regard; to consider; to deem.
Fiddle :: To play (a tune) on a fiddle.
Refuted :: of Refute
Scarlatina :: Scarlet fever.
Calculus :: A method of computation; any process of reasoning by the use of symbols; any branch of m
Galactin :: "An amorphous  gelatinous substance containing nitrogen  found in milk and other animal 
Unmuffle :: "To remove the muffling of  as a drum."
Reclaimable :: That may be reclaimed.
Laas :: A lace. See Lace.
Alexandrine :: Belonging to Alexandria; Alexandrian.
Flighty :: Fleeting; swift; transient.
Saddled :: of Saddle
Resume :: A summing up; a condensed statement; an abridgment or brief recapitulation.
Horologe :: A servant who called out the hours.
Restore :: To make good; to make amends for.
Reptile :: "Creeping; moving on the belly  or by means of small and short legs."
Glires :: An order of mammals; the Rodentia.
Rondle :: "A round mass  plate  or disk; especially (Metal.)  the crust or scale which forms upon th
Accident :: "Literally  a befalling; an event that takes place without one's foresight or expectatio
Act :: "A formal solemn writing  expressing that something has been done."
Tagtail :: A person who attaches himself to another against the will of the latter; a hanger-on.
Babylonic :: Alt. of Babylonical
Unsorted :: Not well selected; ill-chosen.
Referrible :: Referable.
Fare :: "To be in any state  or pass through any experience  good or bad; to be attended with any ci
O' :: A shortened form of of or on.
Sadden :: "To make dull- or sad-colored  as cloth."
Lesson :: "A portion of Scripture read in divine service for instruction; as  here endeth the first 
Hippophagist :: One who eats horseflesh.
Affirmer :: One who affirms.
Level :: "A line or surface to which  at every point  a vertical or plumb line is perpendicular; a l
Lacunal :: Alt. of Lacunar
Acridity :: Alt. of Acridness
Palestrian :: Alt. of Palestrical
Tableaux :: of Tableau
Riotise :: Excess; tumult; revelry.
Reiterate :: "To repeat again and again; to say or do repeatedly; sometimes  to repeat."
Scampish :: "Of or like a scamp; knavish; as  scampish conduct."
Sagus :: A genus of palms from which sago is obtained.
Sea devil :: The angler.
Vesselfuls :: of Vesselful
Fordo :: To overcome with fatigue; to exhaust.
Frim :: Flourishing; thriving; fresh; in good case; vigorous.
Forkerve :: "See Forcarve  v. t."
Homoeomery :: Same as Homoeomeria.
Hipshot :: "Having the hip dislocated; hence  having one hip lower than the other."
Forgemen :: of Forgeman
Unisonous :: Being in unison; unisonant.
Sacrosciatic :: "Of or pertaining to both the sacrum and the hip; as  the sacrosciatic foramina form
Zigzagged :: of Zigzag
Nasobuccal :: "Connected with both the nose and the mouth; as  the nasobuccal groove in the skate."
Give :: "To excite or cause to exist  as a sensation; as  to give offense; to give pleasure or pain.
Riotour :: A rioter.
Rover :: One who practices robbery on the seas; a pirate.
Rid :: "imp. &amp; p. p. of Ride  v. i."
Unlawlike :: Not according to law; being or done in violation of law; unlawful.
Leafy :: "Full of leaves; abounding in leaves; as  the leafy forest."
Hollander :: "A very hard  semi-glazed  green or dark brown brick  which will not absorb water; -- c
Scutcheon :: "A small plate of metal  as the shield around a keyhole. See Escutcheon  4."
Genista :: A genus of plants including the common broom of Western Europe.
Nouch :: An ouch; a jewel.
Pacu :: "A South American freah-water fish (Myleies pacu)  of the family Characinidae. It is highly 
Flowerage :: "State of flowers; flowers  collectively or in general."
Sconce :: A fixed seat or shelf.
Recount :: "To tell over; to relate in detail; to recite; to tell or narrate the particulars of; to 
Ruffian :: "A pimp; a pander; also  a paramour."
Water eagle :: The osprey.
Paleolithic :: "Of or pertaining to an era marked by early stone implements. The Paleolithic era (as
Legend :: "An inscription  motto  or title  esp. one surrounding the field in a medal or coin  or pl
Read :: "Hence  to know fully; to comprehend."
Gormandizing :: of Gormandize
Ridgeling :: A half-castrated male animal.
Hurra :: "A word used as a shout of joy  triumph  applause  encouragement  or welcome."
Felting :: of Felt
Saturated :: "Having its affinity satisfied; combined with all it can hold; -- said of certain atoms
Accusement :: Accusation.
Xylophagous :: Of or pertaining to the genus Xylophaga.
Utricularia :: "A genus of aquatic flowering plants  in which the submersed leaves bear many little 
Groined :: "Built with groins; as  a groined ceiling; a groined vault."
Advantaged :: of Advantage
Gigget :: Same as Gigot.
Zircono :: See Zirco-.
Unplaced :: Not placed.
Handyfight :: A fight with the hands; boxing.
Gulch :: A glutton.
Aggression :: "The first attack  or act of hostility; the first act of injury  or first act leading 
Fennec :: "A small  African  foxlike animal (Vulpes zerda) of a pale fawn color  remarkable for the 
Alveolus :: "A small depression  sac  or vesicle  as the socket of a tooth  the air cells of the lun
Reinvestigate :: To investigate again.
Pachalic :: See Pashalic.
Glaire :: See Glair.
Heteroclitic :: Alt. of Heteroclitical
Leap :: A basket.
Rapparee :: "A wild Irish plunderer  esp. one of the 17th century; -- so called from his carrying a 
Flexuous :: Having alternate curvatures in opposite directions; bent in a zigzag manner.
Alienator :: One who alienates.
Sarplier :: "A coarse cloth made of hemp  and used for packing goods  etc."
Gull :: One easily cheated; a dupe.
Ketch :: A hangman. See Jack Ketch.
Roundabout :: A dance performed in a circle.
Fissipalmate :: "Semipalmate and loboped  as a grebe's foot. See Illust. under Aves."
Headborough :: Alt. of Headborrow
Pad :: "To imbue uniformly with a mordant; as  to pad cloth."
Hyporadii :: of Hyporadius
Heat :: "Utmost violence; rage; vehemence; as  the heat of battle or party."
Ruby :: The color of a ruby; carmine red; a red tint.
Goulards extract :: "An aqueous solution of the subacetate of lead  used as a lotion in cases of inf
Resumed :: of Resume
Related :: "Standing in relation or connection; as  the electric and magnetic forcec are closely rel
Fifteen :: "A symbol representing fifteen units  as 15  or xv."
Wah :: The panda.
Glut :: "The broad-nosed eel (Anguilla latirostris)  found in Europe  Asia  the West Indies  etc."
Cadbait :: See Caddice.
Sea mouse :: The dunlin.
Lentiginous :: Of or pertaining to lentigo; freckly; scurfy; furfuraceous.
Reservoir :: "A place where anything is kept in store; especially  a place where water is collected 
Abide :: To stand the consequences of; to answer for; to suffer for.
Honoring :: of Honor
Felly :: In a fell or cruel manner; fiercely; barbarously; savagely.
Scrapepenny :: One who gathers and hoards money in trifling sums; a miser.
Verseman :: Same as Versemonger.
Fit :: "In Old English  a song; a strain; a canto or portion of a ballad; a passus."
Hent :: of Hent
Reem :: To open (the seams of a vessel's planking) for the purpose of calking them.
Rumen :: The first stomach of ruminants; the paunch; the fardingbag. See Illust. below. 
Accept :: To receive with favor; to approve.
Herse :: "Same as Hearse  v. t."
Hierarchy :: Dominion or authority in sacred things.
Aketon :: See Acton.
Glazing :: of Glase
Future :: A future tense.
Acceptance :: State of being accepted; acceptableness.
Nosegay :: A bunch of odorous and showy flowers; a bouquet; a posy.
Rostellate :: "Having a rostellum  or small beak; terminating in a beak."
Flame :: To burst forth like flame; to break out in violence of passion; to be kindled with zeal or 
Aliment :: That which nourishes; food; nutriment; anything which feeds or adds to a substance in nat
Alhambresque :: "Made or decorated after the fanciful style of the ornamentation in the Alhambra  wh
Lean :: "Wanting fullness  richness  sufficiency  or productiveness; deficient in quality or content
Fordo :: To destroy; to undo; to ruin.
Yardwand :: A yardstick.
Nucula :: "A genus of small marine bivalve shells  having a pearly interior."
Gainpain :: Bread-gainer; -- a term applied in the Middle Ages to the sword of a hired soldier.
Honest :: Chaste; faithful; virtuous.
Undersparred :: Having spars smaller than the usual dimension; -- said of vessels.
Wallower :: A lantern wheel; a trundle.
Painter :: "The panther  or puma."
Reshipper :: One who reships.
Farther :: "Moreover; by way of progress in treating a subject; as  farther  let us consider the pro
Hockday :: "A holiday commemorating the expulsion of the Danes  formerly observed on the second Tues
Goodness :: "The quality of being good in any of its various senses; excellence; virtue; kindness; b
Vacancy :: Unemployed time; interval of leisure; time of intermission; vacation.
Rhapsodize :: "To utter as a rhapsody  or in the manner of a rhapsody"
Gawk :: To act like a gawky.
Hygeian :: "Relating to Hygeia  the goddess of health; of or pertaining to health  or its preservati
Galician :: A native of Galicia in Spain; -- called also Gallegan.
Flunlyism :: The quality or characteristics of a flunky; readiness to cringe to those who are superi
Amaranthine :: "Unfading  as the poetic amaranth; undying."
Aisled :: Furnished with an aisle or aisles.
Lenitive :: A mild purgative; a laxative.
Glistering :: of Glister
Wail :: Loud weeping; violent lamentation; wailing.
Scathe :: Alt. of Scath
Grit :: "A hard  coarse-grained siliceous sandstone; as  millstone grit; -- called also gritrock and
Reft :: Bereft.
Flock :: "Woolen or cotton refuse (sing. / pl.)  old rags  etc.  reduced to a degree of fineness by 
Jointly :: In a joint manner; together; unitedly; in concert; not separately.
Fenestral :: Pertaining to a window or to windows.
Sarcocol :: Alt. of Sarcocolla
Force :: To compel (an adversary or partner) to trump a trick by leading a suit of which he has none
Gobbled :: of Gobble
Fillip :: Something serving to rouse or excite.
Ear :: Same as Acroterium.
Navigable :: "Capable of being navigated; deep enough and wide enough to afford passage to vessels; 
Gripper :: "In printing presses  the fingers or nippers."
Labyrinthodonta :: "An extinct order of Amphibia  including the typical genus Labyrinthodon  and man
Ydrad :: Dreaded.
Alabaster :: "A compact variety or sulphate of lime  or gypsum  of fine texture  and usually white a
Callosan :: Of the callosum.
Usucaption :: The acquisition of the title or right to property by the uninterrupted possession of i
Nonett :: The titmouse.
Albumen :: The white of an egg.
Gathered :: of Gather
Warp :: To turn aside from the true direction; to cause to bend or incline; to pervert.
Re sign :: Resignation.
Salix :: "A genus of trees or shrubs including the willow  osier  and the like  growing usually in w
Allegoric :: Alt. of Allegorical
Humanity :: Mental cultivation; liberal education; instruction in classical and polite literature.
Gig :: A kind of spear or harpoon. See Fishgig.
Rosenmuller's organ :: The parovarium.
Sawdust :: "Dust or small fragments of wood (or of stone  etc.) made by the cutting of a saw."
Reparation :: "The act of making amends or giving satisfaction or compensation for a wrong  injury  
Rolling :: "Having gradual  rounded undulations of surface; as  a rolling country; rolling land."
Unsensed :: Wanting a distinct meaning; having no certain signification.
Scarified :: of Scarify
High-swelling :: Inflated; boastful.
Embassador :: A minister of the highest rank sent to a foreign court to represent there his sovereig
Ninth :: A chord of the dominant seventh with the ninth added.
Haste :: "Celerity of motion; speed; swiftness; dispatch; expedition; -- applied only to voluntary b
Handling :: "A touching  controlling  managing  using  etc.  with the hand or hands  or as with the 
Madreporian :: Alt. of Madreporic
Sculp :: To sculpture; to carve; to engrave.
Frontal :: "A movable  decorative member in metal  carved wood  or  commonly  in rich stuff or in em
Urohaematin :: "Urinary haematin; -- applied to the normal coloring matter of the urine  on the supp
Rudd :: "A fresh-water European fish of the Carp family (Leuciscus erythrophthalmus). It is about th
Ferriage :: The price or fare to be paid for passage at a ferry.
Re-sound :: To sound again or anew.
Headmold shot :: Alt. of Headmould shot
Nucleobranch :: Belonging to the Nucleobranchiata.
Languishingly :: In a languishing manner.
Raven :: To obtain or seize by violence.
Able-bodied :: "Having a sound  strong body; physically competent; robust."
Ravin :: Alt. of Ravine
Nectarizing :: of Nectarize
Uplander :: The upland sandpiper.
Leasing :: The act of lying; falsehood; a lie or lies.
Naif :: Having a true natural luster without being cut; -- applied by jewelers to a precious stone.
German :: Nearly related; closely akin.
Easiness :: "Freedom from effort  constraint  or formality; -- said of style  manner  etc."
Frible :: Frivolous; trifling; sily.
Rounder :: A tool for making an edge or surface round.
Novelize :: To put into the form of novels; to represent by fiction.
Refrainment :: Act of refraining.
Fashion :: To make according to the rule prescribed by custom.
Unprince :: To deprive of the character or authority of a prince; to divest of principality of sover
Ropeband :: "A small piece of spun yarn or marline  used to fasten the head of the sail to the spar.
Lath-shaped :: "Having a slender elongated form  like a lath; -- said of the feldspar of certain ign
Sanctus :: An anthem composed for these words.
Launch :: "The boat of the largest size belonging to a ship of war; also  an open boat of any size d
Frelte :: Frailty.
Baa :: The cry or bleating of a sheep; a bleat.
Ham :: The region back of the knee joint; the popliteal space; the hock.
Uncastle :: To take a castle from; to turn out of a castle.
Gospeler :: A priest or deacon who reads the gospel at the altar during the communion service.
Graining :: "Indentation; roughening; milling  as on edges of coins."
Gland :: "A special organ of plants  usually minute and globular  which often secretes some kind of 
Sea owl :: The lumpfish.
Larder :: A room or place where meat and other articles of food are kept before they are cooked.
Sarsen :: "One of the large sandstone blocks scattered over the English chalk downs; -- called also 
Hairbrush :: A brush for cleansing and smoothing the hair.
Fury :: "Violent anger; extreme wrath; rage; -- sometimes applied to inanimate things  as the wind o
Fust :: "A strong  musty smell; mustiness."
Ricture :: A gaping.
Friz :: "That which is frizzed; anything crisped or curled  as a wig; a frizzle."
Roweled :: of Rowel
Adaw :: To subdue; to daunt.
Rosary :: "A series of prayers (see Note below) arranged to be recited in order  on beads; also  a s
Forthcoming :: Ready or about to appear; making appearance.
Hydage :: A land tax. See Hidage.
Revocation :: "The act of calling back  or the state of being recalled; recall."
Noddy :: "Any tern of the genus Anous  as A. stolidus."
Gustable :: Capable of being tasted; tastable.
Rut :: "To have a strong sexual impulse at the reproductive period; -- said of deer  cattle  etc."
Resided :: of Reside
Laniate :: To tear in pieces.
Frump :: A contemptuous speech or piece of conduct; a gibe or flout.
Hound :: A houndfish.
Vauquelinite :: "Chromate of copper and lead  of various shades of green."
Wash :: "To remove by washing to take away by  or as by  the action of water; to drag or draw off as
Ebonies :: of Ebony
Rackwork :: "Any mechanism having a rack  as a rack and pinion."
Key :: "That part of a mechanism which serves to lock up  make fast  or adjust to position."
Wand :: A staff of authority.
Viceroy :: "A large and handsome American butterfly (Basilarchia  / Limenitis  archippus). Its wings
Hornedness :: The condition of being horned.
Saymaster :: A master of assay; one who tries or proves.
Grater :: "One who  or that which  grates; especially  an instrument or utensil with a rough  indent
Grape fruit :: The shaddock.
Nassa :: "Any species of marine gastropods  of the genera Nassa  Tritia  and other allied genera of 
Favor :: The object of regard; person or thing favored.
Liabilities :: of Liability
Rabbinically :: In a rabbinical manner; after the manner of the rabbins.
Aband :: To banish; to expel.
Scruou-lize :: To perplex with scruples; to regard with scruples.
Flogger :: One who flogs.
Abolitionism :: The principles or measures of abolitionists.
Absorption :: "The act or process of absorbing or sucking in anything  or of being absorbed and made
Roseworm :: "The larva of any one of several species of lepidopterous insects which feed upon the le
Jaspoid :: Resembling jasper.
Palette :: A breastplate for a breast drill.
Roofing :: The materials of which a roof is composed; materials for a roof.
Rondel :: Same as Rondeau.
Figeater :: A large beetle (Allorhina nitida) which in the Southern United States destroys figs.  Th
Rhynchocoela :: Same as Nemertina.
Allegation :: "A statement by a party of what he undertakes to prove  -- usually applied to each sep
Alloy :: To form a metallic compound.
Hookedness :: The state of being bent like a hook; incurvation.
Repine :: Vexation; mortification.
Rancho :: "A rude hut  as of posts  covered with branches or thatch  where herdsmen or farm laborers
Hoopoo :: "A European bird of the genus Upupa (U. epops)  having a beautiful crest  which it can ere
Backhander :: A backhanded blow.
Pained :: of Pain
Hydrogenated :: of Hydrogenate
Lightsome :: Having light; lighted; not dark or gloomy; bright.
Scopula :: A peculiar brushlike organ found on the foot of spiders and used in the construction of t
Ninety :: The sum of nine times ten; the number greater by a unit than eighty-nine; ninety units or 
Licensed :: "Having a license; permitted or authorized by license; as  a licensed victualer; a licen
Abbreviation :: "One dash  or more  through the stem of a note  dividing it respectively into quaver
Gardened :: of Garden
Heritor :: A proprietor or landholder in a parish.
Glyoxalic :: "Pertaining to  or designating  an aldehyde acid  intermediate between glycol and oxali
Honorable :: "An epithet of respect or distinction; as  the honorable Senate; the honorable gentlema
Jug :: "To seethe or stew  as in a jug or jar placed in boiling water; as  to jug a hare."
Heel :: "To perform by the use of the heels  as in dancing  running  and the like."
Refortification :: "A fortifying anew  or a second time."
