Rossel current :: A portion of the southern equatorial current flowing westward from the Fiji Island
Graduate :: "To admit or elevate to a certain grade or degree; esp.  in a college or university  to 
Return :: "To retort; to throw back; as  to return the lie."
Notobranchiata :: A division of nudibranchiate mollusks having gills upon the back.
Scripture :: Anything written; a writing; a document; an inscription.
Water power :: "The power of water employed to move machinery  etc."
Valuableness :: The quality of being valuable.
False :: To mislead by want of truth; to deceive.
Guise :: External appearance in manner or dress; appropriate indication or expression; garb; shape.
Tab :: "A tag. See Tag  2."
Hem :: To border; to edge
Key :: "A family of tones whose regular members are called diatonic tones  and named key tone  (or t
Fusain :: "A drawing made with it. See Charcoal  n. 2  and Charcoal drawing  under Charcoal."
Hesperian :: Any one of the numerous species of Hesperidae; a skipper.
Allude :: To compare allusively; to refer (something) as applicable.
Right-handed :: "Using the right hand habitually  or more easily than the left."
Glandular :: Containing or supporting glands; consisting of glands; pertaining to glands.
Granulate :: To raise in granules or small asperities; to make rough on the surface.
Almagra :: "A fine  deep red ocher  somewhat purplish  found in Spain. It is the sil atticum of the 
Calf :: "A small mass of ice set free from the submerged part of a glacier or berg  and rising to th
Keen :: "Acute of mind; sharp; penetrating; having or expressing mental acuteness; as  a man of keen
Air :: "Carriage; attitude; action; movement; as  the head of that portrait has a good air."
Narcotine :: "An alkaloid found in opium  and extracted as a white crystalline substance  tasteless 
False :: Not in tune.
Nucleate :: Having a nucleus; nucleated.
Frequenting :: of Frequent
Neography :: A new method or system of writing.
Jockey :: "To play the jockey toward; to cheat; to trick; to impose upon in trade; as  to jockey a c
Regrant :: The act of granting back to a former proprietor.
Fother :: A wagonload; a load of any sort.
Reputation :: Account; value.
Scaleless :: Destitute of scales.
Ridiculer :: One who ridicules.
Ribbon :: "To adorn with  or as with  ribbons; to mark with stripes resembling ribbons."
Falsify :: To make false; to represent falsely.
Aforenamed :: Named before.
Fleurs-de-lis :: of Fleur-de-lis
Rookery :: A dilapidated building with many rooms and occupants; a cluster of dilapidated or mean bu
Resupinated :: Resupinate.
Adjunctive :: Joining; having the quality of joining; forming an adjunct.
Hulk :: A heavy ship of clumsy build.
Furl :: "To draw up or gather into close compass; to wrap or roll  as a sail  close to the yard  sta
Kage :: A chantry chapel inclosed with lattice or screen work.
Keilhau-ite :: "A mineral of a brownish black color  related to titanite in form. It consists chiefl
Helter-skelter :: In hurry and confusion; without definite purpose; irregularly.
Homodynamic :: Homodynamous.
Racket :: To make a confused noise or racket.
Sabling :: of Sable
Fetter :: "To restrain from motion; to impose restraints on; to confine; to enchain; as  fettered by
Machete :: "A large heavy knife resembling a broadsword  often two or three feet in length  -- used 
Haul :: A pulling with force; a violent pull.
Nephritical :: "Relieving disorders of the kidneys; affecting the kidneys; as  a nephritic medicine.
Light :: "To set fire to; to cause to burn; to set burning; to ignite; to kindle; as  to light a can
Kampylite :: A variety of mimetite or arseniate of lead in hexagonal prisms of a fine orange yellow.
Holocryptic :: Wholly or completely concealing; incapable of being deciphered.
Redfin :: "A small North American dace (Minnilus cornutus  or Notropis megalops). The male  in the b
Renownless :: Without renown; inglorius.
Aliases :: of Alias
Nighted :: Overtaken by night; belated.
Fluctuant :: Moving like a wave; wavering
Washpot :: A pot containing melted tin into which the plates are dipped to be coated.
Vent :: "A small aperture; a hole or passage for air or any fluid to escape; as  the vent of a cask;
Re-forming :: of Re-form
Sap :: "To proceed by mining  or by secretly undermining; to execute saps."
Adversative :: "Expressing contrariety  opposition  or antithesis; as  an adversative conjunction (b
Frequented :: of Frequent
Natural :: "Produced by natural organs  as those of the human throat  in distinction from instrument
Government :: The mode of governing; the system of polity in a state; the established form of law.
Heep :: The hip of the dog-rose.
Round :: "Not inconsiderable; large; hence  generous; free; as  a round price."
Nabob :: A deputy or viceroy in India; a governor of a province of the ancient Mogul empire.
Ambaginous :: Ambagious.
Hyacinth :: "A plant of the genus Camassia (C. Farseri)  called also Eastern camass; wild hyacinth."
Scroll :: "A mark or flourish added to a person's signature  intended to represent a seal  and in so
Calefactory :: "A hollow sphere of metal  filled with hot water  or a chafing dish  placed on the al
Vest :: Any outer covering; array; garb.
Gracing :: of Grace
Saxon :: "One of a nation or people who formerly dwelt in the northern part of Germany  and who  wit
Abolisher :: One who abolishes.
Hydrobromate :: Same as Hydrobromide.
Jew :: "Originally  one belonging to the tribe or kingdom of Judah; after the return from the Babylo
Houp :: See Hoopoe.
Gentes :: of Gens
Vallums :: of Vallum
Necessariness :: The quality of being necessary.
Xenomi :: A suborder of soft-rayed fresh-water fishes of which the blackfish of Alaska (Dallia pecto
Palestinean :: Of or pertaining to Palestine.
Gnome :: A small owl (Glaucidium gnoma) of the Western United States.
Receiver :: "That portion of a telephonic apparatus  or similar system  at which the message is rece
Ham :: "The thigh of any animal; especially  the thigh of a hog cured by salting and smoking."
Horsewomen :: of Horsewoman
Goose :: A silly creature; a simpleton.
High :: Arrogant; lofty; boastful; proud; ostentatious; -- used in a bad sense.
Grate :: "A structure or frame containing parallel or crosed bars  with interstices; a kind of latti
Falsicrimen :: The crime of falsifying.
Sagamore :: A juice used in medicine.
Novation :: Innovation.
Horseweed :: "A composite plant (Erigeron Canadensis)  which is a common weed."
Resolve :: To be separated into its component parts or distinct principles; to undergo resolution.
Futurition :: The state of being future; futurity.
Alimentally :: So as to serve for nourishment or food; nourishing quality.
Figurate :: Figurative; metaphorical.
Warrant :: "To secure to  as a purchaser of goods  the title to the same; to indemnify against loss.
Homage :: "A symbolical acknowledgment made by a feudal tenant to  and in the presence of  his lord 
Remedially :: In a remedial manner.
Jacobus :: "An English gold coin  of the value of twenty-five shillings sterling  struck in the reig
Nephelometer :: An instrument for measuring or registering the amount of cloudiness.
Fice :: "A small dog; -- written also fise  fyce  fiste  etc."
Geodesy :: "That branch of applied mathematics which determines  by means of observations and measur
Calcinatory :: A vessel used in calcination.
Hardiness :: Hardihood; boldness; firmness; assurance.
Vaultage :: "Vaulted work; also  a vaulted place; an arched cellar."
Vertical :: "A vertical line  plane  or circle."
Nereocystis :: A genus of gigantic seaweeds.
Scope :: Extended area.
Recapture :: "The act of retaking or recovering by capture; especially  the retaking of a prize or g
Jansenism :: The doctrine of Jansen regarding free will and divine grace.
Guardful :: Cautions; wary; watchful.
Laying :: "The act of one who  or that which  lays."
Sapidity :: The quality or state of being sapid; taste; savor; savoriness.
Fret :: To be vexed; to be chafed or irritated; to be angry; to utter peevish expressions.
Vibrissa :: "One of the specialized or tactile hairs which grow about the nostrils  or on other part
Repealing :: of Repeal
Furies :: "See Fury  3."
Tail :: "Hence  the back  last  lower  or inferior part of anything  -- as opposed to the head  or t
Sawed :: of Saw
Hob :: "The flat projection or iron shelf at the side of a fire grate  where things are put to be ke
Roundly :: Openly; boldly; peremptorily; plumply.
Rudderstock :: "The main part or blade of the rudder  which is connected by hinges  or the like  wit
Echinidan :: One the Echinoidea.
Scratchback :: "A toy which imitates the sound of tearing cloth  -- used by drawing it across the ba
Grave :: Of great weight; heavy; ponderous.
Laryngitis :: Inflammation of the larynx.
Alimonious :: Affording food; nourishing.
Revie :: "To meet a wager on  as on the taking of a trick  with a higher wager."
Wanly :: "In a wan  or pale  manner."
Nosed :: of Nose
Fortuitous :: Happening independently of human will or means of foresight; resulting from unavoidabl
Recapture :: That which is captured back; a prize retaken.
Rope :: "To draw  as with a rope; to entice; to inveigle; to decoy; as  to rope in customers or vote
Fill :: To furnish an abudant supply to; to furnish with as mush as is desired or desirable; to occu
Adagial :: Pertaining to an adage; proverbial.
Hatching :: "A mode of execution in engraving  drawing  and miniature painting  in which shading is 
Paining :: of Pain
Lammergeier :: "A very large vulture (Gypaetus barbatus)  which inhabits the mountains of Southern E
Schmelze :: "A kind of glass of a red or ruby color  made in Bohemia."
Agennesis :: Impotence; sterility.
Notched :: of Notch
Genethlialogy :: Divination as to the destinies of one newly born; the act or art of casting nativit
Amadou :: "A spongy  combustible substance  prepared from fungus (Boletus and Polyporus) which grows
Ulotrichan :: Of or pertaining to the Ulotrichi.
Pale :: "To inclose with pales  or as with pales; to encircle; to encompass; to fence off."
Flesh :: "To remove flesh  membrance  etc.  from  as from hides."
Hetairism :: Alt. of Hetarism
Haling :: of Hale
Aggregately :: Collectively; in mass.
Return :: "An account  or formal report  of an action performed  of a duty discharged  of facts or s
Sanctimonial :: Sanctimonious.
Jetty :: "Made of jet  or like jet in color."
Humorousness :: Moodiness; capriciousness.
Gunner :: A warrant officer in the navy having charge of the ordnance on a vessel.
Unfrequency :: Infrequency.
Fussed :: of Fuss
Screen :: "To pass  as coal  gravel  ashes  etc.  through a screen in order to separate the coarse f
Unproficiency :: Want of proficiency or improvement.
Rapture :: To transport with excitement; to enrapture.
Kand :: Fluor spar; -- so called by Cornish miners.
Glaciate :: To turn to ice.
Value :: "To raise to estimation; to cause to have value  either real or apparent; to enhance in val
Grangerite :: One who collects illustrations from various books for the decoration of one book.
Hazard :: To try the chance; to encounter risk or danger.
Echinate :: Alt. of Echinated
Hypnum :: The largest genus of true mosses; feather moss.
Affiance :: "To betroth; to pledge one's faith to for marriage  or solemnly promise (one's self or a
Accelerated :: of Accelerate
Grandinous :: Consisting of hail; abounding in hail.
Glanced :: of Glance
Hair :: "Hair (human or animal) used for various purposes; as  hair for stuffing cushions."
Grimness :: Fierceness of look; sternness; crabbedness; forbiddingness.
Flintiness :: The state or quality of being flinty; hardness; cruelty.
Verse :: A portion of an anthem to be performed by a single voice to each part.
Figment :: An invention; a fiction; something feigned or imagined.
Feria :: "A week day  esp. a day which is neither a festival nor a fast."
Seam :: A line or depression left by a cut or wound; a scar; a cicatrix.
Vagus :: Wandering; -- applied especially to the pneumogastric nerve.
Runnel :: A rivulet or small brook.
Guard :: Ornamental lace or hem protecting the edge of a garment.
Vapor :: "Something unsubstantial  fleeting  or transitory; unreal fancy; vain imagination; idle tal
Forge :: "To make falsely; to produce  as that which is untrue or not genuine; to fabricate; to coun
Relativeness :: "The state of being relative  or having relation; relativity."
Light :: "Not of the legal  standard  or usual weight; clipped; diminished; as  light coin."
Legitimatize :: To legitimate.
Nowel :: "The bottom part of a mold or of a flask  in distinction from the cope; the drag."
Federalist :: "An advocate of confederation; specifically (Amer. Hist.)  a friend of the Constitutio
Lactodensimeter :: "A form of hydrometer  specially graduated  for finding the density of milk  and 
Fang :: To enable to catch or tear; to furnish with fangs.
Vae :: See Voe.
Fretty :: Adorned with fretwork.
Tailpin :: The center in the spindle of a turning lathe.
Replantable :: That may be planted again.
Riddle :: "Something proposed to be solved by guessing or conjecture; a puzzling question; an ambigu
Reputation :: Specifically: Good reputation; favorable regard; public esteem; general credit; good n
Homodromous :: Moving in the same direction; -- said of a lever or pulley in which the resistance an
Unsaint :: To deprive of saintship; to deny sanctity to.
Gharry :: Any wheeled cart or carriage.
Grime :: "Foul matter; dirt  rubbed in; sullying blackness  deeply ingrained."
Zizania :: "A genus of grasses including Indian rice.  See Indian rice  under Rice."
Learning :: "The knowledge or skill received by instruction or study; acquired knowledge or ideas in
Unrebukable :: Not deserving rebuke or censure; blameless.
Hutch :: A jig for washing ore.
Saucer :: Something resembling a saucer in shape.
Caesural :: Of or pertaining to a caesura.
Humiliation :: The act of humiliating or humbling; abasement of pride; mortification.
Accidentality :: The quality of being accidental; accidentalness.
Rubidic :: Of or pertaining to rubidium; containing rubidium.
Return :: To revert; to pass back into possession.
Lead :: "The action of a tooth  as a tooth of a wheel  in impelling another tooth or a pallet."
Unmingle :: "To separate  as things mixed."
Legitimation :: The act of making legitimate.
Neither :: not either; generally used to introduce the first of two or more coordinate clauses of wh
Herbivore :: One of the Herbivora.
Gadder :: "One who roves about idly  a rambling gossip."
Grist :: "In rope making  a given size of rope  common grist being a rope three inches in circumfere
Kafilah :: See Cafila.
Heterotaxy :: "Variation in arrangement from that existing in a normal form; heterogenous arrangemen
Tagger :: That which is pointed like a tag.
Age :: "The whole duration of a being  whether animal  vegetable  or other kind; lifetime."
Amber :: Ambergris.
Paduasoy :: A rich and heavy silk stuff.
Flop :: "To turn suddenly  as something broad and flat."
Gean :: "A species of cherry tree common in Europe (Prunus avium); also  the fruit  which is usually
Sanguinary :: "Attended with much bloodshed; bloody; murderous; as  a sanguinary war  contest  or ba
Resudation :: Act of sweating again.
Residual :: The difference between the mean of several observations and any one of them.
Recollecting :: of Recollect
Gibbeting :: of Gibbet
Accord :: "To grant as suitable or proper; to concede; to award; as  to accord to one due praise."
Namesake :: "One that has the same name as another; especially  one called after  or named out of re
Scratch :: "Made  done  or happening by chance; arranged with little or no preparation; determined b
Gulling :: of Gull
Roar :: The sound of roaring.
Admitting :: of Admit
Refuge :: "That which shelters or protects from danger  or from distress or calamity; a stronghold w
Hoop :: "A circle  or combination of circles  of thin whalebone  metal  or other elastic material  u
About :: "In the immediate neighborhood of; in contiguity or proximity to; near  as to place; by or 
Favor :: "To afford advantages for success to; to facilitate; as  a weak place favored the entrance 
Jerkinhead :: "The hipped part of a roof which is hipped only for a part of its height  leaving a tr
Tableaux vivants :: of Tableau vivant
Letchy :: See Leachy.
Babylonian :: An inhabitant of Babylonia  (which included Chaldea); a Chaldean.
Glory :: "An emanation of light supposed to proceed from beings of peculiar sanctity. It is represen
I- :: See Y-.
Ferrocyanide :: One of a series of complex double cyanides of ferrous iron and some other base.
Sciatic :: "Of or pertaining to the hip; in the region of  or affecting  the hip; ischial; ischiatic
Hemistich :: "Half a poetic verse or line  or a verse or line not completed."
Scute :: "A bony scale of a reptile or fish; a large horny scale on the leg of a bird  or on the bel
Yerd :: See 1st &amp; 2d Yard.
Allowedly :: By allowance; admittedly.
Ginned :: of Gin
Yawn :: "A chasm  mouth  or passageway."
Scullery :: "Hence  refuse; filth; offal."
Univalved :: "Having one valve; as  a univalve shell or pericarp."
Glide :: "To pass with a glide  as the voice."
Unboy :: To divest of the traits of a boy.
Haphazard :: Extra hazard; chance; accident; random.
Uprise :: To have an upward direction or inclination.
Norite :: A granular crystalline rock consisting essentially of a triclinic feldspar (as labradorite
Fleaking :: "A light covering of reeds  over which the main covering is laid  in thatching houses."
Feverfew :: "A perennial plant (Pyrethrum  / Chrysanthemum  Parthenium) allied to camomile  having f
Recollection :: "The act of recollecting  or recalling to the memory; the operation by which objects
Feneration :: The act of fenerating; interest.
Fillister :: The rabbet on the outer edge of a sash bar to hold the glass and the putty.
Heavy :: "Not raised or made light; as  heavy bread."
Hooker :: A sailor's contemptuous term for any antiquated craft.
Jarvy :: The driver of a hackney coach.
Feather-pated :: Feather-headed; frivolous.
Reviling :: Uttering reproaches; containing reproaches.
Ray :: "To send forth or shoot out; to cause to shine out; as  to ray smiles."
Rencountering :: of Rencounter
Ruby :: "Ruby-colored; red; as  ruby lips."
Acquiesced :: of Acquiesce
Acerous :: "Destitute of tentacles  as certain mollusks."
Alborak :: The imaginary milk-white animal on which Mohammed was said to have been carried up to hea
Legateship :: The office of a legate.
Feoffment :: The grant of a feud or fee.
Flanking :: of Flank
Nonsensical :: Without sense; unmeaning; absurb; foolish; irrational; preposterous.
Ruff :: "A limicoline bird of Europe and Asia (Pavoncella  / Philommachus  pugnax) allied to the san
Nematoid :: Of or pertaining to the Nematoidea.
Neginoth :: Stringed instruments.
Nudge/ :: of Nudge
Adumbrant :: "Giving a faint shadow  or slight resemblance; shadowing forth."
Forswear :: To swear falsely; to commit perjury.
Gastromalacia :: A softening of the coats of the stomach; -- usually a post-morten change.
Rid :: of Rid
Fire :: The burning of a house or town; a conflagration.
Heterostyled :: Having styles of two or more distinct forms or lengths.
Juke :: The neck of a bird.
Affixes :: of Affix
Lama :: See Llama.
Gunroom :: "An apartment on the after end of the lower gun deck of a ship of war  usually occupied a
Hybrid :: "Produced from the mixture of two species; as  plants of hybrid nature."
Salt :: The act of leaping or jumping; a leap.
Absolute :: "Viewed apart from modifying influences or without comparison with other objects; actual
Hindoos :: of Hindu
Admitted :: Received as true or valid; acknowledged.
Fourfold :: "Four times; quadruple; as  a fourfold division."
Horopteric :: Of or pertaining to the horopter.
Get :: "To obtain mental possession of; to learn; to commit to memory; to memorize; as to get a less
Hardy :: "Inured to fatigue or hardships; strong; capable of endurance; as  a hardy veteran; a hardy
Lave :: The remainder; others.
Gilthead :: "The Crenilabrus melops  of the British coasts; -- called also golden maid  conner  sea 
Albee :: Although; albeit.
Naphthalate :: A salt of naphthalic acid; a phthalate.
Sclerosis :: "Induration; hardening; especially  that form of induration produced in an organ by inc
Recollection :: The act or practice of collecting or concentrating the mind; concentration; self-con
Flog :: To beat or strike with a rod or whip; to whip; to lash; to chastise with repeated blows.
Gammon :: An imposition or hoax; humbug.
Yaguarundi :: Same as Jaguarondi.
Amaranth :: A color inclining to purple.
Sardonian :: Sardonic.
Sea fern :: Any gorgonian which branches like a fern.
Sanderling :: "A small gray and brown sandpiper (Calidris arenaria) very common on sandy beaches in 
Fruitful :: "Full of fruit; producing fruit abundantly; bearing results; prolific; fertile; liberal;
Racker :: A horse that has a racking gait.
Hedging bill :: A hedge bill. See under Hedge.
Scarifying :: of Scarify
Kevel :: A strong cleat to which large ropes are belayed.
Wanze :: To wane; to wither.
Nameless :: "Without a name; not having been given a name; as  a nameless star."
Gamy :: "Showing an unyielding spirit to the last; plucky; furnishing sport; as  a gamy trout."
Unfence :: To strip of a fence; to remove a fence from.
Ungainly :: "Not gainly; not expert or dexterous; clumsy; awkward; uncouth; as  an ungainly strut in
Forhall :: To harass; to torment; to distress.
Wabble :: "A hobbling  unequal motion  as of a wheel unevenly hung; a staggering to and fro."
Glitteringly :: In a glittering manner.
Roching cask :: A tank in which alum is crystallized from a solution.
Aguardiente :: "A strong alcoholic drink  especially pulque."
Resuscitant :: "One who  or that which resuscitates. Also used adjectively."
Laudative :: Laudatory.
Recover :: "To restore from sickness  faintness  or the like; to bring back to life or health; to cu
Affiliated :: of Affiliate
Gong :: "A flat saucerlike bell  rung by striking it with a small hammer which is connected with it 
Hindbrain :: "The posterior of the three principal divisions of the brain  including the epencephalo
Nonplused :: of Nonplus
Jogging :: The act of giving a jog or jogs; traveling at a jog.
Altitude :: "The elevation of a point  or star  or other celestial object  above the horizon  measur
Relent :: Stay; stop; delay.
Flocculent :: Clothed with small flocks or flakes; woolly.
Falcon :: "One of a family (Falconidae) of raptorial birds  characterized by a short  hooked beak  s
Geniture :: Generation; procreation; birth.
Reif :: Robbery; spoil.
Funiliform :: "Resembling a cord in toughness and flexibility  as the roots of some endogenous trees
Heulandite :: "A mineral of the Zeolite family  often occurring in amygdaloid  in foliated masses  a
Vespertilio :: A genus of bats including some of the common small insectivorous species of North Ame
Sappiness :: The quality of being sappy; juiciness.
Respecting :: "With regard or relation to; regarding; concerning; as  respecting his conduct there i
Rotator :: "that which gives a rotary or rolling motion  as a muscle which partially rotates or turn
Vaut :: A vault; a leap.
Acquaintance :: A person or persons with whom one is acquainted.
Fealty :: "Fidelity to one's lord; the feudal obligation by which the tenant or vassal was bound to 
Finale :: "The closing part  piece  or scene in any public performance or exhibition."
Aliquot :: "An aliquot part of a number or quantity is one which will divide it without a remainder;
Frayed :: of Fray
Friend :: "One who looks propitiously on a cause  an institution  a project  and the like; a favorer
Yeel :: An eel.
Undoubted :: "Not doubted; not called in question; indubitable; indisputable; as  undoubted proof; u
Goodlyhood :: Goodness; grace; goodliness.
Randall grass :: The meadow fescue (Festuca elatior). See under Grass.
Urbane :: Courteous in manners; polite; refined; elegant.
Gewgaw :: A showy trifle; a toy; a splendid plaything; a pretty but worthless bauble.
Forme :: Same as Pate or Patte.
Leisure :: "Time at one's command  free from engagement; convenient opportunity; hence  convenience;
Honeymoon :: The first month after marriage.
Adeptist :: A skilled alchemist.
Grided :: of Gride
Lift :: "To steal; to carry off by theft (esp. cattle); as  to lift a drove of cattle."
Nevadite :: "A grantitoid variety of rhyolite  common in Nevada."
Rise :: To become of higher value; to increase in price.
Unwearied :: "Not wearied; not fatigued or tired; hence  persistent; not tiring or wearying; indefat
Healed :: of Heal
Scratching :: With the action of scratching.
Yeoman :: "An interior officer under the boatswain  gunner  or carpenters  charged with the stowage 
Adlocution :: See Allocution.
Watchhouse :: A place where persons under temporary arrest by the police of a city are kept; a polic
Ebonite :: "A hard  black variety of vulcanite. It may be cut and polished  and is used for many sma
Necromantic :: Alt. of Necromantical
Grandiose :: Impressive or elevating in effect; imposing; splendid; striking; -- in a good sense.
Howl :: To utter a sound expressive of distress; to cry aloud and mournfully; to lament; to wail.
Rubble :: "Water-worn or rough broken stones; broken bricks  etc.  used in coarse masonry  or to fil
Residence :: The residing of an incumbent on his benefice; -- opposed to nonresidence.
Reinspection :: The act of reinspecting.
Abstractional :: Pertaining to abstraction.
Last :: "Next before the present; as  I saw him last week."
Reception :: The state of being received.
Unlimited :: "Undefined; indefinite; not bounded by proper exceptions; as  unlimited terms."
Jackal :: "One who does mean work for another's advantage  as jackals were once thought to kill game
Unwares :: Unawares; unexpectedly; -- sometimes preceded by at.
Latinize :: "To give Latin terminations or forms to  as to foreign words  in writing Latin."
Ketone :: "One of a large class of organic substances resembling the aldehydes  obtained by the dist
Laquearia :: of Laquear
Near :: Closely connected or related.
Scrim :: "A kind of light cotton or linen fabric  often woven in openwork patterns  -- used for curt
Fumet :: Alt. of Fumette
Flattened :: of Flatten
Palm :: A lineal measure equal either to the breadth of the hand or to its length from the wrist to 
Retire :: "A call sounded on a bugle  announcing to skirmishers that they are to retire  or fall bac
Hydrangea :: "A genus of shrubby plants bearing opposite leaves and large heads of showy flowers  wh
Glutaeus :: "The great muscle of the buttock in man and most mammals  and the corresponding muscle i
Unstrength :: Want of strength; weakness; feebleness.
Formidably :: In a formidable manner.
Geologized :: of Geologize
Relay :: "To lay again; to lay a second time; as  to relay a pavement."
Scorbute :: Scurvy.
Report :: "To make a report  or response  in respect of a matter inquired of  a duty enjoined  or in
Scorify :: "To reduce to scoria or slag; specifically  in assaying  to fuse so as to separate the ga
Gore :: "A wedgeshaped or triangular piece of cloth  canvas  etc.  sewed into a garment  sail  etc. 
Revest :: "To take effect or vest again  as a title; to revert to former owner; as  the title or rig
Valleys :: of Valley
Fundament :: "The part of the body on which one sits; the buttocks; specifically (Anat.)  the anus."
Aged :: "Having a certain age; at the age of; having lived; as  a man aged forty years."
No :: A refusal by use of the wordd no; a denial.
Have :: To get possession of; to obtain; to get.
Retrenchment :: "A work constructed within another  to prolong the defense of the position when the 
Ladybird :: "Any one of numerous species of small beetles of the genus Coccinella and allied genera 
Nonuser :: A not using; failure to use.
Hematinometer :: A form of hemoglobinometer.
Rescuable :: That may be rescued.
Gynandromorphism :: "An abnormal condition of certain animals  in which one side has the external ch
Hurter :: "A butting piece; a strengthening piece  esp.: (Mil.) A piece of wood at the lower end of 
Jesuitism :: Cunning; deceit; deceptive practices to effect a purpose; subtle argument; -- an opprob
Lavatory :: A place for washing.
Numeral :: Of or pertaining to number; consisting of number or numerals.
Lallation :: "An imperfect enunciation of the letter r  in which it sounds like l."
Rouse :: "To wake from sleep or repose; as  to rouse one early or suddenly."
Unprobably :: Improbably.
Roost :: "To sit  rest  or sleep  as fowls on a pole  limb of a tree  etc.; to perch."
Scout :: A projecting rock.
Footglove :: A kind of stocking.
Cabbler :: One who works at cabbling.
Releasable :: That may be released.
Sanitarian :: An advocate of sanitary measures; one especially interested or versed in sanitary meas
Reremouse :: The leather-winged bat (Vespertilio murinus).
Hawthorn :: "A thorny shrub or tree (the Crataegus oxyacantha)  having deeply lobed  shining leaves 
Frustule :: "The siliceous shell of a diatom. It is composed of two valves  one overlapping the othe
Lambert pine :: "The gigantic sugar pine of California and Oregon (Pinus Lambertiana). It has the le
Acquaintant :: An acquaintance.
Madhouse :: A house where insane persons are confined; an insane asylum; a bedlam.
Unabridged :: "Not abridged  or shortened; full; complete; entire; whole."
Uprouse :: To rouse up; to rouse from sleep; to awake; to arouse.
Herdic :: A kind of low-hung cab.
Cacochymical :: "Having the fluids of the body vitiated  especially the blood."
Hennes :: Hence.
Rat-tailed :: "Having a long  tapering tail like that of a rat."
Fanlike :: Resembling a fan;
Jointer :: "One who  or that which  joints."
Calceiform :: "Shaped like a slipper  as one petal of the lady's-slipper; calceolate."
Uniped :: Having only one foot.
Scamble :: To mangle.
Lift :: A rope leading from the masthead to the extremity of a yard below; -- used for raising or su
Jaghirdar :: The holder of a jaghir.
Hydrophanous :: Made transparent by immersion in water.
Junketries :: Sweetmeats.
Backarack :: See Bacharach.
Great :: Pregnant; big (with young).
Friended :: of Friend
Fractious :: "Apt to break out into a passion; apt to scold; cross; snappish; ugly; unruly; as  a fr
Scarlet :: Cloth of a scarlet color.
Sciamachy :: See Sciomachy.
Unpervert :: To free from perversion; to deliver from being perverted; to reconvert.
Flame :: Burning zeal or passion; elevated and noble enthusiasm; glowing imagination; passionate exc
Ruin :: "That which is fallen down and become worthless from injury or decay; as  his mind is a ruin
Allaying :: of Allay
Relative :: "Characterizing or pertaining to chords and keys  which  by reason of the identify of so
Air pipe :: A pipe for the passage of air; esp. a ventilating pipe.
Horse-drench :: A dose of physic for a horse.
Geneagenesis :: Alternate generation. See under Generation.
Gesture :: To accompany or illustrate with gesture or action; to gesticulate.
Financiered :: of Financier
Namelessly :: In a nameless manner.
Noninflectional :: "Not admitting of  or characterized by  inflection."
Name :: "A person  an individual."
Acetifier :: An apparatus for hastening acetification.
Hoten :: of Hote
Hogpen :: A pen or sty for hogs.
Cacophonic :: Alt. of Cacophonious
Fretted :: Ornamented with fretwork; furnished with frets; variegated; made rough on the surface.
Ropery :: Tricks deserving the halter; roguery.
Bacchantic :: Bacchanalian.
Sauce-alone :: Jack-by-the-hedge. See under Jack.
Reenter :: "To cut deeper  as engraved lines on a plate of metal  when the engraving has not been de
Mad :: An earthworm.
Jesting :: The act or practice of making jests; joking; pleasantry.
Gerrymandered :: of Gerrymander
Repercussion :: Rapid reiteration of the same sound.
Humanitarian :: "Pertaining to humanitarians  or to humanitarianism; as  a humanitarian view of Chri
Veil :: A cover; disguise; a mask; a pretense.
Least :: "Smallest  either in size or degree; shortest; lowest; most unimportant; as  the least inse
Xylobalsamum :: The dried twigs of a Syrian tree (Balsamodendron Gileadense).
Noose :: "A running knot  or loop  which binds the closer the more it is drawn."
Factor :: "One who transacts business for another; an agent; a substitute; especially  a mercantile 
Repreve :: To reprove.
Goosefoot :: A genus of herbs (Chenopodium) mostly annual weeds; pigweed.
Hafter :: A caviler; a wrangler.
Palla :: "An oblong rectangular piece of cloth  worn by Roman ladies  and fastened with brooches."
Fraternize :: "To associate or hold fellowship as brothers  or as men of like occupation or characte
Iambus :: "A foot consisting of a short syllable followed by a long one  as in /mans  or of an unacc
Caesuras :: of Caesura
Galangal :: "The pungent aromatic rhizome or tuber of certain East Indian or Chinese species of Alpi
Resolved :: of Resolve
Nest :: "An aggregated mass of any ore or mineral  in an isolated state  within a rock."
Haplessly :: "In a hapless  unlucky manner."
Glaciate :: "To produce glacial effects upon  as in the scoring of rocks  transportation of loose ma
Hold :: "To receive and retain; to contain as a vessel; as  this pail holds milk; hence  to be able 
Aaron's rod :: "A plant with a tall flowering stem; esp. the great mullein  or hag-taper  and the go
Horny :: "Composed or made of horn  or of a substance resembling horn; of the nature of horn."
Rock :: A large concreted mass of stony material; a large fixed stone or crag. See Stone.
Freedom :: Generosity; liberality.
Undubitable :: "Indubitable; as  an undubitable principle."
Yardstick :: "A stick three feet  or a yard  in length  used as a measure of cloth  etc."
Naphthaline :: See Naphthalene.
Washer :: The common raccoon.
Hypothenar :: The hypothenar eminence.
Legal :: According to the old or Mosaic dispensation; in accordance with the law of Moses.
Alloying :: of Alloy
Rant :: "High-sounding language  without importance or dignity of thought; boisterous  empty declama
Affected :: Regarded with affection; beloved.
Advancive :: Tending to advance.
Adhered :: of Adhere
Scaly :: "Composed of scales lying over each other; as  a scaly bulb; covered with scales; as  a sca
Garnish :: "A fee; specifically  in English jails  formerly an unauthorized fee demanded by the old 
Lance :: To throw in the manner of a lance. See Lanch.
Glinted :: of Glint
Glandulosity :: Quality of being glandulous; a collection of glands.
Bacchanalianism :: The practice of bacchanalians; bacchanals; drunken revelry.
Finnikin :: "A variety of pigeon  with a crest somewhat resembling the mane of a horse."
Adventureful :: Given to adventure.
Jee :: See Gee.
Judgment :: "A calamity regarded as sent by God  by way of recompense for wrong committed; a provide
Racking :: Spun yarn used in racking ropes.
Acorned :: Furnished or loaded with acorns.
Jack :: A machine for twisting the sliver as it leaves the carding machine.
Tachygraphy :: The art or practice of rapid writing; shorthand writing; stenography.
Sad :: Sated; satisfied; weary; tired.
Relieving :: of Relieve
NoctilucAe :: of Noctiluca
Flyfish :: "A California scorpaenoid fish (Sebastichthys rhodochloris)  having brilliant colors."
Pair :: "To be joined in paris; to couple; to mate  as for breeding."
Granger :: A farm steward.
Lace :: "To adorn with narrow strips or braids of some decorative material; as  cloth laced with sil
Redan :: "A step or vertical offset in a wall on uneven ground  to keep the parts level."
Undertake :: "To assume  as a character."
Unconscionable :: "Not guided by  or conformed to  conscience."
Baalim :: of Baal
Unfold :: "To open the folds of; to expand; to spread out; as  to unfold a tablecloth."
Guzzler :: An immoderate drinker.
Ringing :: of Ring
Scale :: "To take off in thin layers or scales  as tartar from the teeth; to pare off  as a surface.
Ramification :: "A small branch or offshoot proceeding from a main stock or channel; as  the ramific
Relay :: A number of men who relieve others in carrying on some work.
Graywacke :: "A conglomerate or grit rock  consisting of rounded pebbles sand firmly united together
Flea-bitten :: "White  flecked with minute dots of bay or sorrel; -- said of the color of a horse."
Freight :: "Employed in the transportation of freight; having to do with freight; as  a freight car.
Flopped :: of Flop
Flouter :: One who flouts; a mocker.
Following :: "One's followers  adherents  or dependents  collectively."
Fucusol :: "An oily liquid  resembling  and possibly identical with  furfurol  and obtained from fuc
Tackling :: "Furniture of the masts and yards of a vessel  as cordage  sails  etc."
Palatial :: "Of or pertaining to a palace; suitable for a palace; resembling a palace; royal; magnif
Node :: The point at which the lines of a funicular machine meet from different angular directions; 
Honey :: "To make agreeable; to cover or sweeten with  or as with  honey."
Tachina :: Any one of numerous species of Diptera belonging to Tachina and allied genera. Their larv
Nib :: A small and pointed thing or part; a point; a prong.
Earthly :: Made of earth; earthy.
Reserve :: That which is excepted; exception.
Heavy :: "Dark with clouds  or ready to rain; gloomy; -- said of the sky."
Adventurous :: Inclined to adventure; willing to incur hazard; prone to embark in hazardous enterpri
Water monitor :: "A very large lizard (Varanaus salvator) native of India. It frequents the borders 
Tagger :: A device for removing taglocks from sheep.
Gum :: "See Gum tree  below."
Vermiculation :: "The act or operation of moving in the manner of a worm; continuation of motion fro
Left-handiness :: The state or quality of being left-handed; awkwardness.
Faster :: One who abstains from food.
Neoplastic :: "Of or pertaining to neoplasty  or neoplasia."
Fornicate :: To commit fornication; to have unlawful sexual intercourse.
Easy-going :: "Moving easily; hence  mild-tempered; ease-loving; inactive."
Flock :: "A Christian church or congregation; considered in their relation to the pastor  or ministe
Schottische :: "A Scotch round dance in 2-4 time  similar to the polka  only slower; also  the music
Unguentous :: Unguentary.
Grass :: To cover with grass or with turf.
Grass :: Popularly: Herbage; the plants which constitute the food of cattle and other beasts; pastur
Florentine :: A kind of silk.
Huckstered :: of Huckster
Glutin :: Same as Gliadin.
Grisamber :: Ambergris.
Hap :: To clothe; to wrap.
Ne'er :: a contraction of Never.
Gadded :: of Gad
Remontant :: "Rising again; -- applied to a class of roses which bloom more than once in a season; t
Fusee :: A kind of match for lighting a pipe or cigar.
Gift :: A bribe; anything given to corrupt.
Saccharoid :: Alt. of Saccharoidal
Agnosticism :: "That doctrine which  professing ignorance  neither asserts nor denies."
Table :: To make board hems in the skirts and bottoms of (sails) in order to strengthen them in the 
Nitro- :: "A combining form (used also adjectively) designating certain compounds of nitrogen or of 
Gavel :: Tribute; toll; custom. [Obs.] See Gabel.
Ut :: "The first note in Guido's musical scale  now usually superseded by do. See Solmization."
Ripen :: "To grow ripe; to become mature  as grain  fruit  flowers  and the like; as  grapes ripen i
Heteroclitous :: Heteroclitic.
Regel :: See Rigel.
You :: "The pronoun of the second person  in the nominative  dative  and objective case  indicating 
Saloon :: "A spacious and elegant apartment for the reception of company or for works of art; a hall
Gemmule :: One of the buds of mosses.
Macrosporic :: Of or pertaining to macrospores.
Foliole :: One of the distinct parts of a compound leaf; a leaflet.
Leghorn :: "A straw plaiting used for bonnets and hats  made from the straw of a particular kind of 
Scabby :: Affected with scabs; full of scabs.
Unauthorize :: To disown the authority of; to repudiate.
Fer :: Far.
Reporter :: "An officer or person who makes authorized statements of law proceedings and decisions  
Hot-brained :: "Ardent in temper; violent; rash; impetuous; as  hot-brained youth."
Recondensation :: The act or process of recondensing.
Warmed :: of Warm
Leadwort :: "A genus of maritime herbs (Plumbago). P. Europaea has lead-colored spots on the leaves 
Hydriodic :: "Pertaining to  or derived from  hydrogen and iodine; -- said of an acid produced by th
Guilloche :: "An ornament in the form of two or more bands or strings twisted over each other in a c
Remnant :: Remaining; yet left.
Latakia :: "A superior quality of Turkish smoking tobacco  so called from the place where produced  
Frogshell :: "One of numerous species of marine gastropod shells  belonging to Ranella and allied ge
Ferreting :: of Ferret
Lector :: "A reader of lections; formerly  a person designated to read lessons to the illiterate."
Absolver :: One who absolves.
Gangway :: "In the English House of Commons  a narrow aisle across the house  below which sit those 
Franchise :: "The district or jurisdiction to which a particular privilege extends; the limits of an
Fisherman :: "A ship or vessel employed in the business of taking fish  as in the cod fishery."
Rejuvenation :: Rejuvenescence.
Hazing :: of Haze
Note :: To butt; to push with the horns.
Flagon :: "A vessel with a narrow mouth  used for holding and conveying liquors. It is generally lar
Fisticuff :: a fight with the fists; boxing.
Group :: "A cluster  crowd  or throng; an assemblage  either of persons or things  collected without
Raise :: "To let go; as in the command  Raise tacks and sheets  i. e.  Let go tacks and sheets."
Fork :: "To raise  or pitch with a fork  as hay; to dig or turn over with a fork  as the soil."
Alkalies :: of Alkali
Hawaiian :: A native of Hawaii.
Ranger :: "The keeper of a public park or forest; formerly  a sworn officer of a forest  appointed b
Reenter :: To enter anew or again.
Fancier :: "One who fancies or has a special liking for  or interest in  a particular object or clas
Nonmanufacturing :: Not carrying on manufactures.
Rehire :: To hire again.
Adjudication :: The act of adjudicating; the act or process of trying and determining judicially.
Herd :: "A number of beasts assembled together; as  a herd of horses  oxen  cattle  camels  elephant
Lesson :: "Anything read or recited to a teacher by a pupil or learner; something  as a portion of a
Grinded :: Ground.
Unquestioned :: Indisputable; not to be opposed or impugned.
Radiate :: "To emit or send out in direct lines from a point or points; as  to radiate heat."
Saligot :: The water chestnut (Trapa natans).
Usufructuary :: A person who has the use of property and reaps the profits of it.
Rust :: To contract rust; to be or become oxidized.
Alkanet :: A boraginaceous herb (Alkanna tinctoria) yielding the dye; orchanet.
Xanthogenate :: A salt of xanthic acid.
Xanthinine :: "A complex nitrogenous substance related to urea and uric acid  produced as a white po
Gilbbery :: Moving easily; nimble; voluble.
Free :: "Without charge; as  children admitted free."
Screw :: A small packet of tobacco.
Sawbill :: The merganser.
Yellowlegs :: "Any one of several species of long-legged sandpipers of the genus Totanus  in which t
Flush :: So as to be level or even.
Universality :: "The quality or state of being universal; unlimited extension or application; genera
Rameal :: Same as Ramal.
Gallivant :: "To play the beau; to wait upon the ladies; also  to roam about for pleasure without an
Rugged :: Not neat or regular; uneven.
Alkalifiable :: "Capable of being alkalified  or converted into an alkali."
Keir :: See Kier.
Nitroquinol :: "A hypothetical nitro derivative of quinol or hydroquinone  not known in the free sta
Warrant :: That which attests or proves; a voucher.
Yelp :: "To utter a sharp  quick cry  as a hound; to bark shrilly with eagerness  pain  or fear; to 
Responsive :: Suited to something else; correspondent.
Water bath :: "A device for regulating the temperature of anything subjected to heat  by surrounding
Femininity :: The quality or nature of the female sex; womanliness.
Hasty :: Demanding haste or immediate action.
Underproper :: "One who  or that which  underprops or supports."
Regular :: "A member of any religious order or community who has taken the vows of poverty  chastity
Pair :: "To suit; to fit  as a counterpart."
Hilliness :: The state of being hilly.
Resumption :: The taking again into the king's hands of such lands or tenements as he had granted to
Fitch :: A vetch.
Keyage :: Wharfage; quayage.
Hangdog :: Low; sneaking; ashamed.
Glutton :: To glut; to eat voraciously.
Retiary :: A retiarius.
Acierage :: The process of coating the surface of a metal plate (as a stereotype plate) with steelli
Rhomb :: "An equilateral parallelogram  or quadrilateral figure whose sides are equal and the opposi
Hieroglyphist :: One versed in hieroglyphics.
Horse power :: The power which a horse exerts.
Underpeep :: To peep under.
Scutelliform :: Having the form of a scutellum.
Acaridan :: "One of a group of arachnids  including the mites and ticks."
Sanded :: Covered or sprinkled with sand; sandy; barren.
Germ :: "That from which anything springs; origin; first principle; as  the germ of civil liberty."
Water chestnut :: "The fruit of Trapa natans and Trapa bicornis  Old World water plants bearing edib
Hierographic :: Alt. of Hierographical
Hellgramite :: "The aquatic larva of a large American winged insect (Corydalus cornutus)  much used 
Sandever :: See Sandiver.
Head :: "The place or honor  or of command; the most important or foremost position; the front; as  
Jeg :: "See Jig  6."
Keep :: "To preserve from danger  harm  or loss; to guard."
Rugged :: "Sour; surly; frowning; wrinkled; -- said of looks  etc."
Flourish :: Decoration; ornament; beauty.
Heuk :: Variant of Huke.
Samoyedes :: An ignorant and degraded Turanian tribe which occupies a portion of Northern Russia and
Langridge :: See Langrage.
Rhomboganoid :: A ganoid fish having rhombic enameled scales; one of the Rhomboganoidei.
Relief :: "The act of relieving  or the state of being relieved; the removal  or partial removal  of
Macerater :: "One who  or that which  macerates; an apparatus for converting paper or fibrous matter
Sea grape :: The gulf weed. See under Gulf.
Reservation :: A proviso.
Frit :: "The material of which glass is made  after having been calcined or partly fused in a furnac
Roan :: A roan horse.
Saturated :: of Saturate
Grabble :: To lie prostrate on the belly; to sprawl on the ground; to grovel.
Vertebrated :: "Contracted at intervals  so as to resemble the spine in animals."
Wait :: "Musicians who sing or play at night or in the early morning  especially at Christmas time; 
Ripen :: To approach or come to perfection.
Tack :: "A rope used to hold in place the foremost lower corners of the courses when the vessel is c
Geognosy :: "That part of geology which treats of the materials of the earth's structure  and its ge
Hemipeptone :: A product of the gastric and pancreatic digestion of albuminous matter.
Alewife :: A woman who keeps an alehouse.
Gift :: Anything given; anything voluntarily transferred by one person to another without compensati
Node :: "One of the two points where the orbit of a planet  or comet  intersects the ecliptic  or th
Respeak :: To speak or utter again.
Fester :: "To be inflamed; to grow virulent  or malignant; to grow in intensity; to rankle."
Nemorous :: Woody.
Libelant :: One who libels; one who institutes a suit in an ecclesiastical or admiralty court.
Scambled :: of Scamble
Kermesse :: See Kirmess.
Saxicolous :: Growing on rocks.
Fuddle :: To make foolish by drink; to cause to become intoxicated.
Recision :: The act of cutting off.
Upsyturvy :: Upside down; topsy-turvy.
Agood :: In earnest; heartily.
Floor :: "A horizontal  flat ore body."
East :: "Toward the rising sun; or toward the point where the sun rises when in the equinoctial; as 
Fenestrule :: One of the openings in a fenestrated structure.
Usurped :: of Usurp
Hemipode :: "Any bird of the genus Turnix. Various species inhabit Asia  Africa  and Australia."
Rebut :: "To make  or put in  an answer  as to a plaintiff's surrejoinder."
Unpolish :: To deprive of polish; to make impolite.
Forsake :: "To quit or leave entirely; to desert; to abandon; to depart or withdraw from; to leave; 
Groving :: of Groove
Halichondriae :: "An order of sponges  having simple siliceous spicules and keratose fibers; -- call
Painful :: "Full of pain; causing uneasiness or distress  either physical or mental; afflictive; dis
Juryman :: "One who is impaneled on a jury  or who serves as a juror."
Reed :: "A name given to many tall and coarse grasses or grasslike plants  and their slender  often 
Bacterium :: "A microscopic vegetable organism  belonging to the class Algae  usually in the form of
Headlong :: Steep; precipitous.
Unbred :: Not taught or trained; -- with to.
Retreat :: "A signal given in the army or navy  by the beat of a drum or the sounding of trumpet or 
Verberation :: The impulse of a body; which causes sound.
Unturned :: Not turned; not revolved or reversed.
Undigestible :: Indigestible.
Fearful :: inclined to fear; easily frightened; without courage; timid.
Furbelowed :: of Furhelow
Garble :: "To sift or bolt  to separate the fine or valuable parts of from the coarse and useless pa
Rout :: A bellowing; a shouting; noise; clamor; uproar; disturbance; tumult.
Flatly :: "In a flat manner; evenly; horizontally; without spirit; dully; frigidly; peremptorily; po
Gairish :: Alt. of Gairish/ness
Unyoke :: To part; to disjoin; to disconnect.
Green :: "A grassy plain or plat; a piece of ground covered with verdant herbage; as  the village gr
Alive :: Of all living (by way of emphasis).
Scripturally :: In a scriptural manner.
Lay :: "To cause to be still; to calm; to allay; to suppress; to exorcise  as an evil spirit."
Unwritten :: "Not written; not reduced to writing; oral; as  unwritten agreements."
Ward :: To defend; to protect.
Water-rot :: "To rot by steeping in water; to water-ret; as  to water-rot hemp or flax."
Age :: "That part of the duration of a being or a thing which is between its beginning and any given
Reeve :: The female of the ruff.
Groove :: "A furrow  channel  or long hollow  such as may be formed by cutting  molding  grinding  t
Four-o'clock :: "The friar bird; -- so called from its cry  which resembles these words."
Helm :: To cover or furnish with a helm or helmet.
Glossolaly :: The gift of tongues. Farrar.
Hornwork :: An outwork composed of two demibastions joined by a curtain. It is connected with the wo
Feasible :: "Fit to be used or tailed  as land."
Reciting :: of Recite
Norwegian :: That branch of the Scandinavian language spoken in Norway.
Roiling :: of Roil
Again :: On the other hand.
Allowance :: "The act of allowing  granting  conceding  or admitting; authorization; permission; san
Zenick :: "A South African burrowing mammal (Suricata tetradactyla)  allied to the civets. It is gra
Reverberating :: of Reverberate
Aaronic :: Alt. of Aaronical
Skrupling :: of Scruple
Alfenide :: An alloy of nickel and silver electroplated with silver.
Sage :: "A suffruticose labiate plant (Salvia officinalis) with grayish green foliage  much used in 
Filanders :: "A disease in hawks  characterized by the presence of small threadlike worms  also of f
Allopathist :: One who practices allopathy; one who professes allopathy.
Unbolt :: To explain or unfold a matter; to make a revelation.
Figurant :: "One who dances at the opera  not singly  but in groups or figures; an accessory charact
Airy :: "Open to a free current of air; exposed to the air; breezy; as  an airy situation."
Homotaxial :: Alt. of Homotaxic
Un- :: "An inseparable prefix  or particle  signifying not; in-; non-. In- is prefixed mostly to wor
Harmonizer :: One who harmonizes.
Gymnoglossa :: A division of gastropods in which the odontophore is without teeth.
Head :: "The uppermost  foremost  or most important part of an inanimate object; such a part as may 
Alliance :: Any union resembling that of families or states; union by relationship in qualities; aff
Go :: A glass of spirits.
Jarosite :: An ocher-yellow mineral occurring on minute rhombohedral crystals. It is a hydrous sulph
Jade :: "A disreputable or vicious woman; a wench; a quean; also  sometimes  a worthless man."
Ware :: Seaweed.
Hydro-electric :: "Pertaining to  employed in  or produced by  the evolution of electricity by means
Cabrit :: Same as Cabree.
Scragginess :: The quality or state of being scraggy; scraggedness.
Laud :: Music or singing in honor of any one.
Addition :: That part of arithmetic which treats of adding numbers.
Reship :: To engage one's self again for service on board of a vessel after having been discharged.
Lawing :: Expeditation.
Acquirer :: A person who acquires.
Leukeness :: "See Luke  etc."
Leviathan :: "An aquatic animal  described in the book of Job  ch. xli.  and mentioned in other pass
Vent :: "To let out at a vent  or small aperture; to give passage or outlet to."
Figurable :: Capable of being brought to a fixed form or shape.
Rational :: A rational being.
Nonextensile :: Not extensile; incapable of being stretched.
Rhombic :: Shaped like a rhomb.
Herling :: Alt. of Hirling
Gemination :: A doubling; duplication; repetition.
Yellowthroat :: "Any one of several species of American ground warblers of the genus Geothlypis  esp
Rorid :: Dewy; bedewed.
Net :: To form network or netting; to knit.
Hypopharynx :: "An appendage or fold on the lower side of the pharynx  in certain insects."
Levee :: The act of rising.
Lemniscus :: One of two oval bodies hanging from the interior walls of the body in the Acanthocephal
Fraternal :: "Pf  pertaining to  or involving  brethren; becoming to brothers; brotherly; as  frater
Gizzard :: A thick muscular stomach found in many invertebrate animals.
Hobanob :: Alt. of Hobandnob
Reluctantly :: In a reluctant manner.
Alarming :: of Alarm
Ruft :: Eructation; belching.
Render :: To return; to pay back; to restore.
Nocturn :: "An office of devotion  or act of religious service  by night."
Hygrodeik :: "A form of hygrometer having wet and dry bulb thermometers  with an adjustable index sh
Renowmed :: Renowned.
Altar :: "In the Christian church  a construction of stone  wood  or other material for the celebrat
Foryelde :: To repay; to requite.
Unconditional :: "Not conditional limited  or conditioned; made without condition; absolute; unreser
Fortlet :: A little fort.
Horsehide :: Leather made of the hide of a horse.
Allonym :: A work published under the name of some one other than the author.
Underditch :: "To dig an underground ditches in  so as to drain the surface; to underdrain; as  to u
Wand :: A small stick; a rod; a verge.
Warbled :: of Warble
Washboard :: "A broad  thin plank  fixed along the gunwale of boat to keep the sea from breaking inb
Geometries :: of Geometry
Sea chickweed :: "A fleshy plant (Arenaria peploides) growing in large tufts in the sands of the nor
Acute-angled :: "Having acute angles; as  an acute-angled triangle  a triangle with every one of its
Hypoptila :: of Hypoptilum
Revoice :: "To refurnish with a voice; to refit  as an organ pipe  so as to restore its tone."
Yarn :: "Spun wool; woolen thread; also  thread of other material  as of cotton  flax  hemp  or silk
Accustomed :: Familiar through use; usual; customary.
Schizognathae :: The schizognathous birds.
Funambulation :: Ropedancing.
Flatulent :: "Turgid with flatus; as  a flatulent tumor."
Rearmost :: Farthest in the rear; last.
Gossip :: "One who runs house to house  tattling and telling news; an idle tattler."
Aheap :: In a heap; huddled together.
Scranny :: Thin; lean; meager; scrawny; scrannel.
Retirade :: "A kind of retrenchment  as in the body of a bastion  which may be disputed inch by inch
Relative :: "Arising from relation; resulting from connection with  or reference to  something else;
Ultramundane :: "Being beyond the world  or beyond the limits of our system."
Ferula :: The imperial scepter in the Byzantine or Eastern Empire.
Hyperspace :: An imagined space having more than three dimensions.
Above :: "More than; as  above five hundred were present."
Refusion :: "New or repeated melting  as of metals."
Rigel :: A fixed star of the first magnitude in the left foot of the constellation Orion.
Abode :: Stay or continuance in a place; sojourn.
Cafeneh :: "A humble inn or house of rest for travelers  where coffee is sold."
Zebec :: See Xebec.
Rugosity :: The quality or state of being rugose.
Glosser :: A polisher; one who gives a luster.
Lapsed :: "Having slipped downward  backward  or away; having lost position  privilege  etc.  by neg
Gendarmes :: of Gendarme
Rag :: "A coarse kind of rock  somewhat cellular in texture."
Nightmare :: A fiend or incubus formerly supposed to cause trouble in sleep.
Flammiferous :: Producing flame.
Legatary :: A legatee.
Underclothes :: "Clothes worn under others  especially those worn next the skin for warmth."
Accelerative :: Relating to acceleration; adding to velocity; quickening.
Salve :: An adhesive composition or substance to be applied to wounds or sores; a healing ointment.
Ruck :: A roc.
Hie :: Haste; diligence.
Alexandrian :: "Applied to a kind of heroic verse. See Alexandrine  n."
Aeonian :: Eternal; everlasting.
Gomer :: "A conical chamber at the breech of the bore in heavy ordnance  especially in mortars; -- n
Hoo :: See Ho.
Scotch :: "To shoulder up; to prop or block with a wedge  chock  etc.  as a wheel  to prevent its ro
Ferrate :: A salt of ferric acid.
Acanthine :: "Of  pertaining to  or resembling  the plant acanthus."
Backslider :: One who backslides.
Gleeman :: A name anciently given to an itinerant minstrel or musician.
Glycide :: "A colorless liquid  obtained from certain derivatives of glycerin  and regarded as a par
Forepossessed :: Preoccupied; prepossessed; preengaged.
Flos-ferri :: "A variety of aragonite  occuring in delicate white coralloidal forms; -- common in be
Gonorrhoea :: "A contagious inflammatory disease of the genitourinary tract  affecting especially th
Redissolve :: To dissolve again.
Unequity :: Want of equity or uprightness; injustice; wickedness; iniquity.
Nempne :: To name or call.
Amazon :: "A tall  strong  masculine woman; a virago."
Vendue :: "A public sale of anything  by outcry  to the highest bidder; an auction."
Adulterate :: Debased by the admixture of a foreign substance; adulterated; spurious.
Lancegaye :: A kind of spear anciently used. Its use was prohibited by a statute of Richard II.
Variety :: The quality or state of being various; intermixture or succession of different things; di
Rood :: "The fourth part of an acre  or forty square rods."
Accompt :: See Account.
Fixation :: The act of uniting chemically with a solid substance or in a solid form; reduction to a 
Vacant :: "Empty of thought; thoughtless; not occupied with study or reflection; as  a vacant mind."
Light :: "Having little  or comparatively little  weight; not tending to the center of gravity with 
Pailful :: The quantity that a pail will hold.
Furring :: "The leveling of a surface  or the preparing of an air space  by means of strips of board
Hoy :: "A small coaster vessel  usually sloop-rigged  used in conveying passengers and goods from pl
Scalper :: A person who buys and sells the unused parts of railroad tickets.
Fair :: "A competitive exhibition of wares  farm products  etc.  not primarily for purposes of sale;
Schematism :: Particular form or disposition of a thing; an exhibition in outline of any systematic 
Rank :: "Elevated grade or standing; high degree; high social position; distinction; eminence; as  a
Rapt :: To transport or ravish.
Reparteeing :: of Repartee
Sceptreless :: "Having no scepter; without authority; powerless; as  a scepterless king."
Caesarism :: "A system of government in which unrestricted power is exercised by a single person  to
Farm :: "The rent of land  -- originally paid by reservation of part of its products."
Libretto :: The words themselves.
Hectorism :: The disposition or the practice of a hector; a bullying.
Frere :: A friar.
Numb :: "Enfeebled in  or destitute of  the power of sensation and motion; rendered torpid; benumbed
Absolutist :: One who believes that it is possible to realize a cognition or concept of the absolute
Heved :: The head.
Flawing :: of Flaw
Neossology :: The study of young birds.
Saccharonic :: "Of  pertaining to  or derived from  saccharone; specifically  designating an unstabl
Ream :: "To bevel out  as the mouth of a hole in wood or metal; in modern usage  to enlarge or dress
Rumply :: Rumpled.
Fluxure :: The quality of being fluid.
Ultramontane :: "One who resides beyond the mountains  especially beyond the Alps; a foreigner."
Foldage :: See Faldage.
Rhachitis :: See Rachitis.
Rupture :: To suffer a breach or disruption.
Flexuous :: Wavering; not steady; flickering.
Undertake :: "Hence  to guarantee; to promise; to affirm."
Jamaicine :: "An alkaloid said to be contained in the bark of Geoffroya inermis  a leguminous tree g
Rising :: of Rise
Vanquish :: "A disease in sheep  in which they pine away."
Ring :: "An inclosed space in which pugilists fight; hence  figuratively  prize fighting."
Rose-pink :: "Having a pink color like that of the rose  or like the pigment called rose pink. See R
Hydrosoma :: "All the zooids of a hydroid colony collectively  including the nutritive and reproduct
Neologianism :: Neologism.
Formulary :: Prescribed form or model; formula.
Rotundo :: See Rotunda.
Wag :: A man full of sport and humor; a ludicrous fellow; a humorist; a wit; a joker.
Flighty :: "Indulging in flights  or wild and unrestrained sallies  of imagination  humor  caprice  
Noetic :: Alt. of Noetical
Machinist :: One skilled in the use of machine tools.
Recitative :: Of or pertaining to recitation; intended for musical recitation or declamation; in the
Screw :: To use violent mans in making exactions; to be oppressive or exacting.
Lieutenant general :: An army officer in rank next below a general and next above a major general.
Reel :: "The act or motion of reeling or staggering; as  a drunken reel."
Scirrhuses :: of Scirrhus
Rendition :: "The act of rendering; especially  the act of surrender  as of fugitives from justice  
Retaliatory :: "Tending to  or involving  retaliation; retaliative; as retaliatory measures."
Glomerate :: "To gather or wind into a ball; to collect into a spherical form or mass  as threads."
Libertine :: Free from restraint; uncontrolled.
Fenestrate :: "Having transparent spots  as the wings of certain butterflies."
Register :: The inner part of the mold in which types are cast.
Holland :: "A kind of linen first manufactured in Holland; a linen fabric used for window shades  ch
Accriminate :: To accuse of a crime.
Acolyte :: "One who has received the highest of the four minor orders in the Catholic church  being 
Liflode :: Livelihood.
Vaporizable :: Capable of being vaporized into vapor.
Viatometer :: A viameter.
Agamous :: Having no visible sexual organs; asexual.
Wastorel :: See Wastrel.
Recovered :: of Recover
Veteran :: "Long exercised in anything  especially in military life and the duties of a soldier; lon
Accent :: "A mark placed at the right hand of a letter  and a little above it  to distinguish magnit
Keystone :: "The central or topmost stone of an arch. This in some styles is made different in size 
Lignify :: To convert into wood or into a ligneous substance.
Glaucine :: Glaucous or glaucescent.
Resultive :: Resultant.
Gemmiparous :: "Producing buds; reproducing by buds. See Gemmation  1."
Renounce :: To cast off or reject deliberately; to disown; to dismiss; to forswear.
Alphabet :: The letters of a language arranged in the customary order; the series of letters or sign
Fantail :: "A variety of the domestic pigeon  so called from the shape of the tail."
Reflection :: "The return of rays  beams  sound  or the like  from a surface. See Angle of reflectio
Wand :: "A rod used by conjurers  diviners  magicians  etc."
Refundment :: "The act of refunding; also  that which is refunded."
Hypochondriums :: of Hypochondrium
Foumart :: "The European polecat; -- called also European ferret  and fitchew. See Polecat."
Hospitaler :: "One of an order of knights who built a hospital at Jerusalem for pilgrims  A. D. 1042
Kelpie :: Alt. of Kelpy
Ais :: of Ai
Frolicful :: Frolicsome.
General :: "One of the chief military officers of a government or country; the commander of an army 
Nucleobranchiata :: See Heteropoda.
Hop :: "The catkin or strobilaceous fruit of the hop  much used in brewing to give a bitter taste."
Ran :: Open robbery.
Always :: "At all times; ever; perpetually; throughout all time; continually; as  God is always the 
Goober :: A peanut.
Radius vector :: "A straight line (or the length of such line) connecting any point  as of a curve  
Sanctify :: To make free from sin; to cleanse from moral corruption and pollution; to purify.
Savacioun :: Salvation.
Allodialism :: The allodial system.
Racquet :: See Racket.
Gens d'armes :: of Gendarme
Justice :: The quality of being just; conformity to the principles of righteousness and rectitude in
Reproduce :: "To produce again  by generation or the like; to cause the existence of (something of t
Unlearned :: "Not exhibiting learning; as  unlearned verses."
Northwesterly :: "Toward the northwest  or from the northwest."
Run :: To tease with sarcasms and ridicule.
Run :: "The horizontal distance to which a drift may be carried  either by license of the proprietor
Jockey :: A dealer in horses; a horse trader.
Accoutrements :: "Dress; trappings; equipment; specifically  the devices and equipments worn by sold
-able :: "An adjective suffix now usually in a passive sense; able to be; fit to be; expressing capa
Habited :: of Habit
Green :: "Not ripe; immature; not fully grown or ripened; as  green fruit  corn  vegetables  etc."
Caesarean :: Alt. of Caesarian
Regular :: "Conformed to a rule; agreeable to an established rule  law  principle  or type  or to es
Gentlemanlike :: Alt. of Gentlemanly
High-reaching :: "Reaching high or upward; hence  ambitious; aspiring."
Repentless :: Unrepentant.
Habnab :: By chance.
Remiped :: One of a group of aquatic beetles having tarsi adapted for swimming. See Water beetle.
Herapathite :: "The sulphate of iodoquinine  a substance crystallizing in thin plates remarkable for
Fusee :: A flintlock gun. See 2d Fusil.
Unseam :: To open the seam or seams of; to rip; to cut; to cut open.
Janitor :: "A door-keeper; a porter; one who has the care of a public building  or a building occupi
Paint :: "To practice the art of painting; as  the artist paints well."
Vascular :: "Of or pertaining to the vessels of animal and vegetable bodies; as  the vascular functi
Foison :: Rich harvest; plenty; abundance.
Nodical :: "Of or pertaining to the nodes; from a node to the same node again; as  the nodical revol
Filibuster :: "To act as a filibuster  or military freebooter."
Gradate :: "To grade or arrange (parts in a whole  colors in painting  etc.)  so that they shall har
Lighthouse :: "A tower or other building with a powerful light at top  erected at the entrance of a 
Radiating :: of Radiate
Lignite :: "Mineral coal retaining the texture of the wood from which it was formed  and burning wit
Taglioni :: "A kind of outer coat  or overcoat; -- said to be so named after a celebrated Italian fa
Geminate :: To double.
Necessary :: "Impossible to be otherwise  or to be dispensed with  without preventing the attainment
Unanswered :: "Not responded to in kind; unrequited; as  unanswered affection."
Alluviums :: of Alluvium
Racketing :: of Racket
Felon :: Characteristic of a felon; malignant; fierce; malicious; cruel; traitorous; disloyal.
Rope :: "To lasso (a steer  horse)."
Goggled :: "Prominent; staring  as the eye."
Forbore :: of Forbear
Nocturnal :: "An instrument formerly used for taking the altitude of the stars  etc.  at sea."
Range :: A bolting sieve to sift meal.
Aheight :: Aloft; on high.
Ungenerous :: Not generous; illiberal; ignoble; unkind; dishonorable.
Water-rotting :: of Water-rot
Laminability :: The quality or state of being laminable.
Albuminose :: A diffusible substance formed from albumin by the action of natural or artificial gast
Sauce :: "To treat with bitter  pert  or tart language; to be impudent or saucy to."
Harbingering :: of Harbinger
Acquaintance :: "A state of being acquainted  or of having intimate  or more than slight or superfic
Water lime :: Hydraulic lime.
Watchword :: "A sentiment or motto; esp.  one used as a rallying cry or a signal for action."
Usant :: Using; accustomed.
Roll :: "A kind of shortened raised biscuit or bread  often rolled or doubled upon itself."
Revel :: To move playfully; to indulge without restraint.
Reglet :: "A strip of wood or metal of the height of a quadrat  used for regulating the space betwee
Race :: "A strong or rapid current of water  or the channel or passage for such a current; a powerfu
Nick :: A particular point or place considered as marked by a nick; the exact point or critical mome
Filicoid :: A fernlike plant.
Rise :: "To become apparent; to emerge into sight; to come forth; to appear; as  an eruption rises o
Affranchise :: To make free; to enfranchise.
Ready :: "A word of command  or a position  in the manual of arms  at which the piece is cocked and 
Historial :: Historical.
Room :: "Place or position in society; office; rank; post; station; also  a place or station once be
Warm :: To make engaged or earnest; to interest; to engage; to excite ardor or zeal; to enliven.
Ruinous :: "Characterized by ruin; ruined; dilapidated; as  an edifice  bridge  or wall in a ruinous
Forge :: The act of beating or working iron or steel; the manufacture of metalic bodies.
Utter :: "hence  to put in circulation  as money; to put off  as currency; to cause to pass in trade
Just :: "Precisely; exactly; -- in place  time  or degree; neither more nor less than is stated."
Female rhymes :: "double rhymes  or rhymes (called in French feminine rhymes because they end in e w
Hesper :: The evening; Hesperus.
Feel :: "To perceive by the touch; to take cognizance of by means of the nerves of sensation distrib
Free :: "Not arbitrary or despotic; assuring liberty; defending individual rights against encroachme
Fig :: "To put into the head of  as something useless o/ contemptible."
Franking :: "A method of forming a joint at the intersection of window-sash bars  by cutting away on
Ringtoss :: A game in which the object is to toss a ring so that it will catch upon an upright stick
Veda :: "The ancient sacred literature of the Hindus; also  one of the four collections  called Rig-
Lager wine :: Wine which has been kept for some time in the cellar.
Lazy :: "Inactive; slothful; slow; sluggish; as  a lazy stream."
Unblind :: To free from blindness; to give or restore sight to; to open the eyes of.
Fecundify :: To make fruitful; to fecundate.
Jacobinize :: "To taint with  or convert to  Jacobinism."
Lear :: Lore; lesson.
Lampoon :: "A personal satire in writing; usually  malicious and abusive censure written only to rep
Schorly :: "Pertaining to  or containing  schorl; as  schorly granite."
Abrogative :: "Tending or designed to abrogate; as  an abrogative law."
Salmon :: of Salmon
Palinode :: "A retraction; esp.  a formal retraction."
Regalia :: "Hence  decorations or insignia of an office or order  as of Freemasons  Odd Fellows etc.
Palladian :: "Of  pertaining to  or designating  a variety of the revived classic style of architect
Last :: The burden of a ship; a cargo.
Groveled :: of Grovel
Heavy :: "Impeding motion; cloggy; clayey; -- said of earth; as  a heavy road  soil  and the like."
Ablegate :: "A representative of the pope charged with important commissions in foreign countries  o
Guaco :: "The Mikania Guaco  of Brazil  used for the same purpose."
Victimizing :: of Victimize
Unfledged :: "Not fledged; not feathered; hence  not fully developed; immature."
Grant :: "A transfer of property by deed or writing; especially  au appropriation or conveyance made
Act :: "To exert power; to produce an effect; as  the stomach acts upon food."
Fling :: To shed forth; to emit; to scatter.
Frication :: Friction.
Schizopod :: Alt. of Schizopodous
Friendly :: Having the temper and disposition of a friend; disposed to promote the good of another; 
Sculpturing :: of Sculpture
Razed :: of Raze
Macule :: "To blur; especially (Print.)  to blur or double an impression from type. See Mackle."
Hideous :: Hateful; shocking.
Larruped :: of Larrup
Lames :: Small steel plates combined together so as to slide one upon the other and form a piece of 
Rat-tail :: "Like a rat's tail in form; as  a rat-tail file  which is round  slender  and tapering. 
Scribbling :: The act of writing hastily or idly.
Unharmonious :: "Inharmonious; unsymmetrical; also  unmusical; discordant."
Yield :: "To give up  as something that is claimed or demanded; to make over to one who has a claim 
Freckle :: To become covered or marked with freckles; to be spotted.
Hema- :: Same as Haema-.
Futurity :: Event to come; a future event.
Francic :: "Pertaining to the Franks  or their language; Frankish."
Sanctiloquent :: "Discoursing on heavenly or holy things  or in a holy manner."
Sculk :: Alt. of Sculker
Warranty :: "A covenant real  whereby the grantor of an estate of freehold and his heirs were bound 
Abietinic :: "Of or pertaining to abietin; as  abietinic acid."
Scyphus :: "A cup-shaped stem or podetium in lichens. Also called scypha. See Illust. of Cladonia py
Wading :: "a. &amp; n. from Wade  v."
Umbratic :: Alt. of Umbratical
Risotto :: A kind of pottage.
Sauf :: Save; except.
Quad :: "A quadrangle; hence  a prison."
Fertilize :: "To make fertile or enrich; to supply with nourishment for plants; to make fruitful or 
Achieve :: "To obtain  or gain  as the result of exertion; to succeed in gaining; to win."
Sauterne :: "A white wine made in the district of Sauterne  France."
Albinoism :: The state or condition of being an albino; albinism.
Hair :: A haircloth.
Natural :: "Conformed to the order  laws  or actual facts  of nature; consonant to the methods of na
Underlease :: "A lease granted by a tenant or lessee; especially  a lease granted by one who is hims
Journal :: Daily; diurnal.
Godling :: A diminutive god.
Godly :: "Pious; reverencing God  and his character and laws; obedient to the commands of God from l
Gesticulation :: Antic tricks or motions.
fetichism :: Alt. of Fetishism
Nestling :: of Nestle
Girdle :: "That which girds  encircles  or incloses; a circumference; a belt; esp.  a belt  sash  or
License :: The document granting such permission.
Glyptodon :: "An extinct South American quaternary mammal  allied to the armadillos. It was as large
Handle :: "That part of vessels  instruments  etc.  which is held in the hand when used or moved  as
Scrutiny :: "A ticket  or little paper billet  on which a vote is written."
Uncinate :: "Hooked; bent at the tip in the form of a hook; as  an uncinate process."
Gaviae :: The division of birds which includes the gulls and terns.
Nonsexual :: Having no distinction of sex; sexless; neuter.
Nominate :: To call; to entitle; to denominate.
Lactiferous :: "Bearing or containing milk or a milky fluid; as  the lactiferous vessels  cells  or 
Faultless :: "Without fault; not defective or imperfect; free from blemish; free from incorrectness 
Redbud :: "A small ornamental leguminous tree of the American species of the genus Cercis. See Judas
Hypnotic :: "A person who exhibits the phenomena of  or is subject to  hypnotism."
Featherless :: Destitute of feathers.
Iatric :: Alt. of Iatrical
Sanguinaria :: "The rootstock of the bloodroot  used in medicine as an emetic  etc."
Saccharate :: "In a wider sense  a compound of saccharose  or any similar carbohydrate  with such ba
Fluocerine :: Alt. of Fluocerite
Tafia :: A variety of rum.
Juniority :: The state or quality of being junior.
Gallipot :: "A glazed earthen pot or vessel  used by druggists and apothecaries for containing medic
Facto :: In fact; by the act or fact.
Bachelor :: An unmarried woman.
Ripost :: A quick and sharp refort; a repartee.
Nereids :: of Nereid
Fundholder :: One who has money invested in the public funds.
Retruse :: Abstruse.
Racket :: To engage in noisy sport; to frolic.
Ungeld :: "A person so far out of the protection of the law  that if he were murdered  no geld  or f
Absurd :: "Contrary to reason or propriety; obviously and fiatly opposed to manifest truth; inconsis
Table-land :: "A broad  level  elevated area of land; a plateau."
Abject :: "Sunk to a law condition; down in spirit or hope; degraded; servile; groveling; despicable
Foxes :: of Fox
Fleak :: A flake; a thread or twist.
Neighbor :: Near to another; adjoining; adjacent; next; neighboring.
Hives :: The croup.
Rhopalium :: One of the marginal sensory bodies of medusae belonging to the Discophora.
Macrura :: "A subdivision of decapod Crustacea  having the abdomen largely developed. It includes th
Hematoma :: A circumscribed swelling produced by an effusion of blood beneath the skin.
Hasheesh :: Alt. of Hashish
Jambeux :: "In the Middle Ages  armor for the legs below the knees."
Gelsemine :: "An alkaloid obtained from the yellow jasmine (Gelsemium sempervirens)  as a bitter whi
Sarcoptes :: A genus of parasitic mites including the itch mites.
Abies :: "A genus of coniferous trees  properly called Fir  as the balsam fir and the silver fir. Th
Zeugma :: "A figure by which an adjective or verb  which agrees with a nearer word  is  by way of su
Hamite :: "A fossil cephalopod of the genus Hamites  related to the ammonites  but having the last w
Gyrostatic :: Of or pertaining to the gyrostat or to gyrostatics.
Landing :: "Of  pertaining to or used for  setting  bringing  or going  on shore."
Esopian :: "Of or pertaining to Aesop  or in his manner."
Reconstruction :: "The act or process of reorganizing the governments of the States which had passed
Lash :: A hair growing from the edge of the eyelid; an eyelash.
Leno :: A light open cotton fabric used for window curtains.
Hetarism :: "A supposed primitive state of society  in which all the women of a tribe were held in c
Numb :: "Producing numbness; benumbing; as  the numb  cold night."
Faltering :: Falter; halting; hesitation.
Scoriform :: In the form of scoria.
Fungibles :: "Things which may be furnished or restored in kind  as distinguished from specific thin
Active :: "Applied to a form of the verb; -- opposed to passive. See Active voice  under Voice. "
Fierce :: "Excessively earnest  eager  or ardent."
Labyrinth :: The internal ear. See Note under Ear.
Easeful :: Full of ease; suitable for affording ease or rest; quiet; comfortable; restful.
Hasp :: "A spindle to wind yarn  thread  or silk on."
Acquaintedness :: State of being acquainted; degree of acquaintance.
Fricando :: "A ragout or fricassee of veal; a fancy dish of veal or of boned turkey  served as an en
Jib :: "The projecting arm of a crane  from which the load is suspended."
Lifeboat :: "A strong  buoyant boat especially designed for saving the lives of shipwrecked people."
Sarcomata :: of Sarcoma
Ease :: "Freedom from constraint  formality  difficulty  embarrassment  etc.; facility; liberty; nat
Hissing :: of Hiss
Wanton :: "A roving  frolicsome thing; a trifler; -- used rarely as a term of endearment."
Hery :: To worship; to glorify; to praise.
Grind :: "To reduce to powder by friction  as in a mill  or with the teeth; to crush into small frag
Ziment-water :: A kind of water found in copper mines; water impregnated with copper.
Foin :: To prick; to st?ng.
Resent :: To be sensible of; to feel
Xylography :: The art of making prints from the natural grain of wood.
Aid-de-camp :: "An officer selected by a general to carry orders  also to assist or represent him in
Adreamed :: "Visited by a dream; -- used in the phrase  To be adreamed  to dream."
Head :: "To form a head; as  this kind of cabbage heads early."
Fatly :: Grossly; greasily.
Roorback :: Alt. of Roorbach
Actinometry :: The measurement of the chemical or actinic energy of light.
Heal :: Health.
Ungulae :: of Ungula
Humped :: "Having a hump  as the back."
Underwrite :: "To subscribe one's name to for insurance  especially for marine insurance; to write o
Almanac :: "A book or table  containing a calendar of days  and months  to which astronomical data a
Easy :: "Free from constraint  harshness  or formality; unconstrained; smooth; as  easy manners; an 
Joker :: One who makes jokes or jests.
Glut :: "To swallow  or to swallow greedlly; to gorge."
Restrain :: "To draw back again; to hold back from acting  proceeding  or advancing  either by physi
Nidulation :: The time of remaining in the nest.
Fidicinal :: Of or pertaining to a stringed instrument.
Ramming :: of Ram
Sciolist :: One who knows many things superficially; a pretender to science; a smatterer.
Reprove :: To chide to the face as blameworthy; to accuse as guilty; to censure.
Fissipation :: Reproduction by fission; fissiparism.
Hydrophobia :: "The disease caused by a bite form  or inoculation with the saliva of  a rabid creatu
Homologous :: "Having the same relative position  proportion  value  or structure."
Yardful :: As much as a yard will contain; enough to fill a yard.
Glowing :: of Glow
Greenness :: Freshness; vigor; newness.
Wagon :: "A wheeled carriage; a vehicle on four wheels  and usually drawn by horses; especially  one
Rostra :: "See Rostrum  2."
Kalong :: "A fruit bat  esp. the Indian edible fruit bat (Pteropus edulis)."
Unswayable :: Not capable of being swayed.
Gaudful :: Joyful; showy.
Guaiacum :: "The heart wood or the resin of the Guaiacum offinale or lignum-vitae  a large tree of t
Retrograde :: "Hence  to decline from a better to a worse condition  as in morals or intelligence."
Frightfully :: In a frightful manner; to a frightful dagree.
Alderney :: "One of a breed of cattle raised in Alderney  one of the Channel Islands. Alderneys are 
Rustic :: Simple; artless; unadorned; unaffected.
Nones :: "The canonical office  being a part of the Breviary  recited at noon (formerly at the ninth
Fraudless :: Free from fraud.
Lever :: "A bar  as a capstan bar  applied to a rotatory piece to turn it."
Justification :: "Adjustment of type by spacing it so as to make it exactly fill a line  or of a cut
Lachrymation :: The act of shedding tears; weeping.
Hypnotic :: "Any agent that produces  or tends to produce  sleep; an opiate; a soporific; a narcotic
Reiterative :: "A word formed from another  or used to form another  by repetition; as  dillydally."
Cabinetwork :: "The art or occupation of working upon wooden furniture requiring nice workmanship; a
Hungerly :: With keen appetite.
Unpeg :: To remove a peg or pegs from; to unfasten; to open.
Recline :: "To cause or permit to lean  incline  rest  etc.; to place in a recumbent position; as  t
Foetus :: Same as Fetus.
Flexicostate :: Having bent or curved ribs.
Kicker :: "One who  or that which  kicks."
Fast :: "A time of fasting  whether a day  week  or longer time; a period of abstinence from food or
Rosewort :: Any plant nearly related to the rose.
Landleaper :: See Landlouper.
Floscular :: Flosculous.
Fardingdale :: A farthingale.
Nef :: The nave of a church.
Figure :: "To make a figure; to be distinguished or conspicious; as  the envoy figured at court."
Hothouse :: "A house kept warm to shelter tender plants and shrubs from the cold air; a place in whi
Legioned :: Formed into a legion or legions; legionary.
Howel :: "A tool used by coopers for smoothing and chamfering rheir work  especially the inside of c
Rounded :: of Round
Figured :: Not literal; figurative.
Account :: To recount; to relate.
Howadji :: A traveler.
Hive :: To take shelter or lodgings together; to reside in a collective body.
Fleet :: To sail; to float.
Rascality :: "The quality or state of being rascally  or a rascal; mean trickishness or dishonesty; 
Venomous :: "Full of venom; noxious to animal life; poisonous; as  the bite of a serpent may be veno
Ferforth :: Far forth.
Fjord :: See Fiord.
Unstep :: "To remove  as a mast  from its step."
Wastrel :: A neglected child; a street Arab.
Hydrostat :: A contrivance or apparatus to prevent the explosion of steam boilers.
Fouty :: Despicable.
Affluently :: Abundantly; copiously.
Adventive :: Accidental.
Laste :: "of Last  to endure."
Rump :: "The end of the backbone of an animal  with the parts adjacent; the buttock or buttocks."
Californian :: A native or inhabitant of California.
Faced :: of Face
Reeding :: "A small convex molding; a reed (see Illust. (i) of Molding); one of several set close to
Fast :: To abstain from food; to omit to take nourishment in whole or in part; to go hungry.
Sea orange :: A large American holothurian (Lophothuria Fabricii) having a bright orange convex body
Painting :: A depicting by words; vivid representation in words.
Yew :: "A bow for shooting  made of the yew."
Reclusive :: Affording retirement from society.
Alcohate :: Shortened forms of Alcoholate.
Sanguineous :: Abounding with blood; sanguine.
Gingerly :: Cautiously; timidly; fastidiously; daintily.
Girdler :: "An American longicorn beetle (Oncideres cingulatus) which lays its eggs in the twigs of 
Rallier :: One who rallies.
Frost :: Coldness or insensibility; severity or rigidity of character.
Heliograph :: "An apparatus for telegraphing by means of the sun's rays. See Heliotrope  3."
Frame :: "A structure of four bars  adjustable in size  on which cloth  etc.  is stretched for quilt
Alternation :: "The reciprocal succession of things in time or place; the act of following and being
Fool-large :: Foolishly liberal.
Kerana :: "A kind of long trumpet  used among the Persians."
Adelopod :: An animal having feet that are not apparent.
Roving :: The act of one who roves or wanders.
Huckle :: The hip; the haunch.
Flung :: of Fling
Hysterology :: "A figure by which the ordinary course of thought is inverted in expression  and the 
Fence :: "Hence  to fight or dispute in the manner of fencers  that is  by thrusting  guarding  parr
Lawless :: "Not subject to  or restrained by  the law of morality or of society; as  lawless men or 
Return :: "To come back  or begin again  after an interval  regular or irregular; to appear again."
Judaize :: "To conform to the doctrines  observances  or methods of the Jews; to inculcate or impose
Hexahemeron :: "The history of the six day's work of creation  as contained in the first chapter of 
Savage :: "Uncivilized; untaught; unpolished; rude; as  savage life; savage manners."
Neoplatonist :: One who held to Neoplatonism; a member of the Neoplatonic school.
Fac :: "A large ornamental letter used  esp. by the early printers  at the commencement of the chapt
Tables d'hote :: of Table d'hote
Pa :: A shortened form of Papa.
Ebb :: Receding; going out; falling; shallow; low.
Fine :: Aiming at show or effect; loaded with ornament; overdressed or overdecorated; showy.
Fatally :: "In a manner proceeding from  or determined by  fate."
Air stove :: "A stove for heating a current of air which is directed against its surface by means of
Hovel :: To put in a hovel; to shelter.
Halt :: To walk lamely; to limp.
Almighty :: Great; extreme; terrible.
Tachygraphical :: Of or pertaining to tachygraphy; written in shorthand.
Ransacked :: of Ransack
Alehouse :: "A house where ale is retailed; hence  a tippling house."
Rapid :: "The part of a river where the current moves with great swiftness  but without actual water
Uncover :: "To divest of the hat or cap; to bare the head of; as  to uncover one's head; to uncover 
Utile :: Profitable; useful.
Karagane :: A species of gray fox found in Russia.
Satyr :: The orang-outang.
Vasiform :: "Having the form of a vessel  or duct."
Abstinent :: One of a sect who appeared in France and Spain in the 3d century.
Grimsir :: A stern man.
Labia :: See Labium.
Retrace :: "To go back  in or over (a previous course); to go over again in a reverse direction; as 
Xiphoid :: Of or pertaining to the xiphoid process; xiphoidian.
Wadsetter :: One who holds by a wadset.
Palatal :: "Uttered by the aid of the palate; -- said of certain sounds  as the sound of k in kirk."
Remedied :: of Remedy
Calisthenis :: Of or pertaining to calisthenics.
Reissue :: To issue a second time.
Reissue :: A second or repeated issue.
Sea bank :: A bank or mole to defend against the sea.
Revolt :: A revolter.
Usance :: Custom; practice; usage.
Sea mat :: Any bryozoan of the genus Flustra or allied genera which form frondlike corals.
Formful :: Creative; imaginative.
Gases :: of Gas
Huswife :: A female housekeeper; a woman who manages domestic affairs; a thirfty woman.
Advowtry :: Adultery.
Regard :: "Hence  to look or front toward; to face."
Fautress :: A patroness.
Reannexation :: Act of reannexing.
Godelich :: Goodly.
Sauntered :: of Saunter
Wager :: "To hazard on the issue of a contest  or on some question that is to be decided  or on some
Umbellic :: "Pertaining to  or obtained from  certain umbelliferous plants; as  umbellic acid."
Faints :: "The impure spirit which comes over first and last in the distillation of whisky; -- the f
Gauge :: "To draw into equidistant gathers by running a thread through it  as cloth or a garment."
Haze :: "Light vapor or smoke in the air which more or less impedes vision  with little or no dampne
Nousel :: Alt. of Nousle
Lavoltateer :: A dancer of the lavolta.
Hamper :: "A large basket  usually with a cover  used for the packing and carrying of articles; as  
Russet :: Cloth or clothing of a russet color.
Scytheman :: One who uses a scythe; a mower.
Honeycombed :: Formed or perforated like a honeycomb.
Region :: The upper air; the sky; the heavens.
Alcarraza :: "A vessel of porous earthenware  used for cooling liquids by evaporation from the exter
Revestry :: Same as Revestiary.
Reciprocality :: The quality or condition of being reciprocal; reciprocalness.
Vaginant :: "Serving to in invest  or sheathe; sheathing."
Fistulae :: of Fistula
Address :: To prepare one's self.
Viinage :: "The place or places adjoining or near; neighborhood; vicinity; as  a jury must be of the
Genys :: See Gonys.
Fatted :: of Fat
Gentile-falcon :: See Falcon-gentil.
Hypochlorite :: "A salt of hypochlorous acid; as  a calcium hypochloride."
Headpan :: The brainpan.
Gorilla :: "A large  arboreal  anthropoid ape of West Africa. It is larger than a man  and is remark
Rotatory :: A rotifer.
Lave :: To bathe; to wash one's self.
Hereby :: Close by; very near.
Fineness :: The quality or condition of being fine.
Fumigating :: of Fumigate
Afflatus :: A breath or blast of wind.
Adherently :: In an adherent manner.
Page :: "Fig.: A record; a writing; as  the page of history."
Calcareousness :: Quality of being calcareous.
Hoe :: "A tool chiefly for digging up weeds  and arranging the earth about plants in fields and gard
Hepaticae :: of Hepatica
Sapphire :: Of or resembling sapphire; sapphirine; blue.
Unconcluding :: Inconclusive.
Revisal :: "The act of revising  or reviewing and reexamining for correction and improvement; revisi
Bacciform :: Having the form of a berry.
Joint :: To provide with a joint or joints; to articulate.
Fauces :: "The throat of a calyx  corolla  etc."
Remanent :: That which remains; a remnant; a residue.
Foreran :: imp. of Forerun.
Grumpy :: Surly; dissatisfied; grouty.
Hobble :: "An unequal gait; a limp; a halt; as  he has a hobble in his gait."
Flowering :: "The act of blossoming  or the season when plants blossom; florification."
Unruliment :: Unruliness.
Round :: "Through a circle  as of friends or houses."
Hot-livered :: Of an excitable or irritable temperament; irascible.
Recapture :: To capture again; to retake.
Form :: "To run to a form  as a hare."
Given :: "Stated; fixed; as  in a given time."
Riparian :: "Of or pertaining to the bank of a river; as  riparian rights."
Oarlock :: "The notch  fork  or other device on the gunwale of a boat  in which the oar rests in row
Laemodipoda :: "A division of amphipod Crustacea  in which the abdomen is small or rudimentary and t
Jobbing :: of Job
Harmine :: "An alkaloid accompanying harmaline (in the Peganum harmala)  and obtained from it by oxi
Rebanish :: To banish again.
Reliable :: Suitable or fit to be relied on; worthy of dependance or reliance; trustworthy.
Abroach :: "Broached; in a condition for letting out or yielding liquor  as a cask which is tapped."
Hub :: A block for scotching a wheel.
Rhyncholite :: A fossil cephalopod beak.
Rig :: A blast of wind.
Harlequin :: To play the droll; to make sport by playing ludicrous tricks.
Nocent :: "Doing hurt  or having a tendency to hurt; hurtful; mischievous; noxious; as  nocent quali
Fogging :: of Fog
Absume :: To consume gradually; to waste away.
Highfaluting :: "High-flown  bombastic language."
Absinthate :: A combination of absinthic acid with a base or positive radical.
Honesty :: "The quality or state of being honest; probity; fairness and straightforwardness of condu
Formularization :: The act of formularizing; a formularized or formulated statement or exhibition.
Reiterant :: Reiterating.
Latibulum :: A concealed hiding place; a burrow; a lair; a hole.
Ganglions :: of Ganglion
Handseling :: of Handsel
Gobet :: See Gobbet.
Realize :: "To make real; to convert from the imaginary or fictitious into the actual; to bring into
Narrow :: "To contract the reach or sphere of; to make less liberal or more selfish; to limit; to co
Airing :: "An exposure to air  or to a fire  for warming  drying  etc.; as  the airing of linen  or 
Hallooed :: of Halloo
Earwigging :: of Earwig
Holily :: Sacredly; inviolably.
Redress :: "To set right  as a wrong; to repair  as an injury; to make amends for; to remedy; to rel
Nazarite :: "A Jew bound by a vow to lave the hair uncut  to abstain from wine and strong drink  and
Gadfly :: "Any dipterous insect of the genus Oestrus  and allied genera of botflies."
Pall :: A kind of rich stuff used for garments in the Middle Ages.
Fascinated :: of Fascinate
Remove :: "To change place in any manner  or to make a change in place; to move or go from one resid
Roman :: "A native  or permanent resident  of Rome; a citizen of Rome  or one upon whom certain righ
Acescency :: The quality of being acescent; the process of acetous fermentation; a moderate degree o
Granger :: A member of a grange.
Accrue :: Something that accrues; advantage accruing.
Rivet :: "Hence  to fasten firmly; to make firm  strong  or immovable; as  to rivet friendship or af
Afflict :: To make low or humble.
Roach :: "The redfin  or shiner."
Scimitar :: "A saber with a much curved blade having the edge on the convex side  -- in use among Mo
Eclectic :: "Consisting  or made up  of what is chosen or selected; as  an eclectic method; an eclec
Rachilla :: Same as Rhachilla.
Untimeliness :: Unseasonableness.
Firefish :: "A singular marine fish of the genus Pterois  family Scorpaenidae  of several species  i
Unsuit :: Not to suit; to be unfit for.
Gentilly :: In a gentle or hoble manner; frankly.
Vestibulum :: "A cavity into which  in certain bryozoans  the esophagus and anus open."
Vegetative :: "Having relation to growth or nutrition; partaking of simple growth and enlargement of
Nitrous :: "Of  pertaining to  or designating  any one of those compounds in which nitrogen has a re
Scornful :: Treated with scorn; exciting scorn.
Resin :: "Any one of a class of yellowish brown solid inflammable substances  of vegetable origin  w
Washstand :: "A piece of furniture holding the ewer or pitcher  basin  and other requisites for wash
Flobert :: A small cartridge designed for target shooting; -- sometimes called ball cap.
Nawab :: "A deputy ruler or viceroy in India; also  a title given by courtesy to other persons of hi
Huntress :: "A woman who hunts or follows the chase; as  the huntress Diana."
Hand :: "That which is  or may be  held in a hand at once"
Alamodality :: The quality of being a la mode; conformity to the mode or fashion; fashionableness.
Warm :: "Having a sensation of heat  esp. of gentle heat; glowing."
Falsify :: "To show  in accounting  (an inem of charge inserted in an account) to be wrong."
Genearch :: The chief of a family or tribe.
Hinder :: To prevent or embarrass; to debar; to shut out.
Ranchmen :: of Ranchman
Gravenstein :: "A kind of fall apple  marked with streaks of deep red and orange  and of excellent f
Abarticulation :: "Articulation  usually that kind of articulation which admits of free motion in th
Russet :: Coarse; homespun; rustic.
Fumer :: One that fumes.
Aiguillette :: "One of the ornamental tags  cords  or loops on some military and naval uniforms."
Bacteria :: of Bacterium
Salt :: "To sprinkle  impregnate  or season with salt; to preserve with salt or in brine; to supply 
Water power :: A fall of water which may be used to drive machinery; a site for a water mill; a wate
Redaction :: The act of redacting; work produced by redacting; a digest.
Glode :: imp. of Glide.
Gabel :: "A rent  service  tribute  custom  tax  impost  or duty; an excise."
Kalmuck :: "A kind of shaggy cloth  resembling bearskin."
Frenum :: Same as Fraenum.
Adynamia :: "Considerable debility of the vital powers  as in typhoid fever."
Galipot :: "An impure resin of turpentine  hardened on the outside of pine trees by the spontaneous 
Amass :: A mass; a heap.
Narrower :: "One who  or that which  narrows or contracts."
Hyacinth :: "A bulbous plant of the genus Hyacinthus  bearing beautiful spikes of fragrant flowers. 
Jig :: To sing to the tune of a jig.
Agony :: "Pain so extreme as to cause writhing or contortions of the body  similar to those made in 
Key :: "A position or condition which affords entrance  control  pr possession  etc.; as  the key of
Altarwise :: "In the proper position of an altar  that is  at the east of a church with its ends tow
Forward :: "To send forward; to send toward the place of destination; to transmit; as  to forward a 
Forray :: The act of ravaging; a ravaging; a predatory excursion. See Foray.
Levelism :: The disposition or endeavor to level all distinctions of rank in society.
Scot-free :: "Free from payment of scot; untaxed; hence  unhurt; clear; safe."
Abatement :: The amount abated; that which is taken away by way of reduction; deduction; decrease; a
Xenylic :: "Pertaining to  derived from  designating  certain amido compounds obtained by reducing c
Randing :: The act or process of making and applying rands for shoes.
Gaudless :: Destitute of ornament.
Agitation :: "Excitement of public feeling by discussion  appeals  etc.; as  the antislavery agitati
Naevose :: Spotted; frecled.
Glow :: Intense excitement or earnestness; vehemence or heat of passion; ardor.
Genu :: The knee.
Gaud :: Deceit; fraud; artifice; device.
Rough :: "Tempestuous; boisterous; stormy; as  rough weather; a rough day."
Mackinaw blanket :: Alt. of Mackinaw
Unapt :: Inapt; slow; dull.
Leviticus :: "The third canonical book of the Old Testament  containing the laws and regulations rel
Amaracus :: A fragrant flower.
Hump :: "A fleshy protuberance on the back of an animal  as a camel or whale."
Hem :: "A border made on sheet-metal ware by doubling over the edge of the sheet  to stiffen it and 
Sceptred :: of Sceptre
Jamesonite :: "A steel-gray mineral  of metallic luster  commonly fibrous massive. It is a sulphide 
Fig :: "A small fruit tree (Ficus Carica) with large leaves  known from the remotest antiquity. It w
Wage :: That for which one labors; meed; reward; stipulated payment for service performed; hire; pay
Sea letter :: The customary certificate of national character which neutral merchant vessels are bou
Neuron :: The brain and spinal cord; the cerebro-spinal axis; myelencephalon.
Factum :: "The due execution of a will  including everything necessary to its validity."
Understand :: "To be apprised  or have information  of; to learn; to be informed of; to hear; as  I 
Sail :: To fly through; to glide or move smoothly through.
Jack :: A sawhorse or sawbuck.
Calefactor :: "A heater; one who  or that which  makes hot  as a stove  etc."
Eared :: Having external ears; having tufts of feathers resembling ears.
Helix :: A caulicule or little volute under the abacus of the Corinthian capital.
Warn :: "To give notice to  of approaching or probable danger or evil; to caution against anything t
Pall :: "A piece of cardboard  covered with linen and embroidered on one side; -- used to put over t
Re-creation :: A forming anew; a new creation or formation.
Recitativo :: Recitative.
Adonic :: An Adonic verse.
Rider :: A robber.
Rounding :: of Round
Yellowseed :: A kind of pepper grass (Lepidium campestre).
Hotly :: In a lustful manner; lustfully.
Maoadam road :: A macadamized road.
Abacinate :: To blind by a red-hot metal plate held before the eyes.
Hooded :: Furnished with a hood or something like a hood.
Acropodium :: The entire upper surface of the foot.
Rack :: "To wash on a rack  as metals or ore."
Karyokinetic :: "Of or pertaining to karyokinesis; as  karyokinetic changes of cell division."
School :: "A place for learned intercourse and instruction; an institution for learning; an educatio
Levelly :: In an even or level manner.
Allmouth :: The angler.
Grease :: To bribe; to corrupt with presents.
Wall-sided :: "Having sides nearly perpendicular; -- said of certain vessels to distinguish them fro
Savior :: "Specifically: The (or our  your  etc.) Savior  he who brings salvation to men; Jesus Chri
Sartorial :: Of or pertaining to the sartorius muscle.
Laminar :: Alt. of Laminal
Hider :: One who hides or conceals.
Recheat :: A strain given on the horn to call back the hounds when they have lost track of the game.
Unagreeable :: Not agreeing or consistent; unsuitable.
Flap :: A disease in the lips of horses.
Garget :: "A distemper in hogs  indicated by staggering and loss of appetite."
Retentive :: "Having power to retain; as  a retentive memory."
Hawkbill :: "A sea turtle (Eretmochelys imbricata)  which yields the best quality of tortoise shell;
Racemose :: "Resembling a raceme; growing in the form of a raceme; as  (Bot.) racemose berries or fl
Letter :: One who retards or hinders.
Ear-bored :: Having the ear perforated.
Gentle :: One well born; a gentleman.
Leche :: "See water buck  under 3d Buck."
Rodomont :: A vain or blustering boaster; a braggart; a braggadocio.
Backwash :: To clean the oil from (wood) after combing.
Light :: The power of perception by vision.
Sea onion :: The officinal squill. See Squill.
Jumble :: "A small  thin  sugared cake  usually ring-shaped."
Grivet :: "A monkey of the upper Nile and Abyssinia (Cercopithecus griseo-viridis)  having the upper
Neighbor :: "To dwell in the vicinity; to be a neighbor  or in the neighborhood; to be near."
Nomology :: The science of law; legislation.
Accommodately :: Suitably; fitly.
Frame :: "To shape; to arrange  as the organs of speech."
Sachet :: "A scent bag  or perfume cushion  to be laid among handkerchiefs  garments  etc.  to perfu
Sand :: "Fine particles of stone  esp. of siliceous stone  but not reduced to dust; comminuted stone
Paleontography :: The description of fossil remains.
Wany :: To wane.
Yarnen :: Made of yarn; consisting of yarn.
Ferro- :: "A prefix  or combining form  indicating ferrous iron as an ingredient; as  ferrocyanide."
Undervalue :: To esteem lightly; to treat as of little worth; to hold in mean estimation; to despise
Rocking :: of Rock
Fool :: To play the fool; to trifle; to toy; to spend time in idle sport or mirth.
Reverse :: To change totally; to alter to the opposite.
Rule :: "Ordibary course of procedure; usual way; comon state or condition of things; as  it is a ru
Aggrieved :: of Aggrieve
Report :: "To give an account of; to relate; to tell; to circulate publicly  as a story; as  in the 
Lee :: "That part of the hemisphere  as one stands on shipboard  toward which the wind blows. See Le
Unsaddle :: "To strip of a saddle; to take the saddle from  as a horse."
Sclerenchymatous :: "Pertaining to  or composed of  sclerenchyma."
Grail :: A book of offices in the Roman Catholic Church; a gradual.
Relating :: of Relate
Jilt :: "To cast off capriciously or unfeeling  as a lover; to deceive in love."
Half blood :: A person whose father and mother are of different races; a half-breed.
Non-feasance :: "An omission or neglect to do something  esp. that which ought to have been done.  C
Sapphirine :: "Resembling sapphire; made of sapphire; having the color  or any quality of sapphire."
Watcher :: "One who watches; one who sits up or continues; a diligent observer; specifically  one wh
Glycogenesis :: "The production or formation of sugar from gycogen  as in the liver."
Hypostome :: Alt. of Hypostoma
Ungored :: Not gored or pierced.
Unembarrassed :: "Free from perplexing connection; as  the question comes into court unembarrassed w
Filamentous :: Like a thread; consisting of threads or filaments.
Jumblement :: Confused mixture.
Galvanism :: "The branch of physical science which treats of dynamical elecricity  or the properties
Rost :: See Roust.
Grocer :: "A trader who deals in tea  sugar  spices  coffee  fruits  and various other commodities."
Heel :: The latter or remaining part of anything; the closing or concluding part.
Velar :: "Having the place of articulation on the soft palate; guttural; as  the velar consonants  s
Hyperotreta :: "An order of marsipobranchs  including the Myxine or hagfish and the genus Bdellostom
Rugged :: "Violent; rude; boisterrous; -- said of conduct  manners  etc."
Rhamphotheca :: The horny covering of the bill of birds.
Aid-major :: The adjutant of a regiment.
Firmly :: In a firm manner.
Unknit :: To undo or unravel what is knitted together.
Achromatically :: In an achromatic manner.
Graminaceous :: "Pertaining to  or resembling  the grasses; gramineous; as  graminaceous plants."
Galley :: "A light  open boat used on the Thames by customhouse officers  press gangs  and also for 
Lead :: "To guide or conduct in a certain course  or to a certain place or end  by making the way kn
Glaired :: of Glair
Grace :: "Graceful and beautiful females  sister goddesses  represented by ancient writers as the at
Nascent :: Evolving; being evolved or produced.
Raker :: A machine for raking grain or hay by horse or other power.
Gush :: "To issue with violence and rapidity  as a fluid; to rush forth as a fluid from confinement;
Gorm :: Axle grease. See Gome.
Ventro- :: "A combining form used in anatomy to indicate connection with  or relation to  the abdome
Tachydidaxy :: A short or rapid method of instructing.
Return :: "The profit on  or advantage received from  labor  or an investment  undertaking  adventur
Finale :: Close; termination
Abscond :: To hide; to conceal.
Lare :: To feed; to fatten.
Jacobuses :: of Jacobus
Grin :: To express by grinning.
Falsifier :: "One who falsifies  or gives to a thing a deceptive appearance; a liar."
Homalographic :: Same as Homolographic.
Headfish :: The sunfish (Mola).
Jungle :: "A dense growth of brushwood  grasses  reeds  vines  etc.; an almost impenetrable thicket 
Fondling :: The act of caressing; manifestation of tenderness.
Scowl :: "To express by a scowl; as  to scowl defiance."
Roofless :: Having no house or home; shelterless; homeless.
Hippotomy :: Anatomy of the horse.
Kibble :: A large iron bucket used in Cornwall and Wales for raising ore out of mines.
Lene :: To lend; to grant; to permit.
Nestorian :: "relating to  or resembling  Nestor  the aged warior and counselor mentioned by Homer; 
Rehabilitating :: of Rehabilitate
Sashing :: of Sash
Latish :: Somewhat late.
Horridly :: In a horrid manner.
Scrobicular :: "Pertaining to  or surrounding  scrobiculae; as  scrobicular tubercles."
Ease :: "To release from pressure or restraint; to move gently; to lift slightly; to shift a little;
Yenite :: A silicate of iron and lime occurring in black prismatic crystals; -- also called ilvaite.
Launder :: "A trough used by miners to receive the powdered ore from the box where it is beaten  or 
Scamilli :: of Scamillus
Runway :: The beaten path made by deer or other animals in passing to and from their feeding grounds
Revolving :: "Making a revolution or revolutions; rotating; -- used also figuratively of time  seaso
Redeliver :: To deliver or give back; to return.
Unconcernment :: "The state of being unconcerned  or of having no share or concern; unconcernedness.
Scythe :: "An instrument for mowing grass  grain  or the like  by hand  composed of a long  curving 
Ramp :: "To spring; to leap; to bound; to rear; to prance; to become rampant; hence  to frolic; to r
Refulgent :: "Casting a bright light; radiant; brilliant; resplendent; shining; splendid; as  refulg
Vacuousness :: The quality or state of being vacuous; emptiness; vacuity.
Nebulose :: Nebulous; cloudy.
Unreaved :: "Not torn  split  or parted; not torn to pieces."
Wallflower :: "A lady at a ball  who  either from choice  or because not asked to dance  remains a s
Rouncy :: A common hackney horse; a nag.
Lay :: An obligation; a vow.
Gormand :: A greedy or ravenous eater; a luxurious feeder; a gourmand.
Alcyonoid :: Like or pertaining to the Alcyonaria.
Gruesome :: Ugly; frightful.
Railing :: "Rails in general; also  material for making rails."
Abusive :: Wrongly used; perverted; misapplied.
Fastly :: Firmly; surely.
Fosseway :: One of the great military roads constructed by the Romans in England and other parts of 
Baddish :: Somewhat bad; inferior.
Rundle :: A round; a step of a ladder; a rung.
Seam :: The quantity of 120 pounds of glass.
Historic :: Alt. of Historical
Caballing :: of Cabal
Halcyonold :: See Alcyonoid.
Ringed :: "Encircled or marked with  or as with  a ring or rings."
Neighborly :: In a neigborly manner.
Babylonian :: An astrologer; -- so called because the Chaldeans were remarkable for the study of ast
Gaited :: "Having (such) a gait; -- used in composition; as  slow-gaited; heavy-gaited."
Warp :: "Four; esp.  four herrings; a cast.  See Cast  n.  17."
Nay :: Denial; refusal.
Ward-corn :: "The duty of keeping watch and ward (see the Note under Watch  n.  1) with a horn to be
Rathripe :: A rareripe.
Aged :: "Old; having lived long; having lived almost to or beyond the usual time allotted to that sp
Mesdames :: of Madame
Lettish :: The language spoken by the Letts. See Lettic.
Alleviate :: To lighten or lessen the force or weight of.
Raffler :: One who raffles.
Scar :: "A mark in the skin or flesh of an animal  made by a wound or ulcer  and remaining after the
Allotropic :: Alt. of Allotropical
Flight :: "Lofty elevation and excursion;a mounting; a soa/ing; as  a flight of imagination  ambitio
Rooked :: of Rook
Forty :: Four times ten; thirty-nine and one more.
Earl marshal :: "An officer of state in England who marshals and orders all great ceremonials  takes
Hall :: "A building or room of considerable size and stateliness  used for public purposes; as  West
Amadavat :: "The strawberry finch  a small Indian song bird (Estrelda amandava)  commonly caged and 
Venenate :: To poison; to infect with poison.
Homophonous :: "Now used for plain harmony  note against note  as opposed to polyphonic harmony  in 
Gastornis :: A genus of large eocene birds from the Paris basin.
Hiss :: "A prolonged sound like that letter s  made by forcing out the breath between the tongue and
Geotropic :: "Relating to  or showing  geotropism."
Paletot :: "A lady's outer garment  -- of varying fashion."
Refrain :: The burden of a song; a phrase or verse which recurs at the end of each of the separate s
Recital :: "The formal statement  or setting forth  of some matter of fact in any deed or writing in
Flook :: A fluke of an anchor.
Tabaret :: "A stout silk having satin stripes  -- used for furniture."
Granulation :: The state of being granulated.
Rigor :: Violence; force; fury.
Frugality :: "A sparing use; sparingness; as  frugality of praise."
Allege :: "To produce or urge as a reason  plea  or excuse; as  he refused to lend  alleging a resol
Veritable :: Agreeable to truth or to fact; actual; real; true; genuine.
Journalism :: "The periodical collection and publication of current news; the business of managing  
Jingoism :: "The policy of the Jingoes  so called. See Jingo  2."
Sea cow :: The walrus.
Folk lore :: "Tales  legends  or superstitions long current among the people."
Earthen :: "Made of earth; made of burnt or baked clay  or other like substances; as  an earthen ves
Adultery :: "The unfaithfulness of a married person to the marriage bed; sexual intercourse by a mar
Levy :: To take or seize on execution; to collect by execution.
Jaculate :: "To throw or cast  as a dart; to throw out; to emit."
Langue d'oil :: "The dialect formerly spoken north of the Loire (in which the word for ""yes"" was o
Genesee epoch :: "The closing subdivision of the Hamilton period in the American Devonian system; --
Legion :: A group of orders inferior to a class.
Uncage :: "To loose  or release  from  or as from  a cage."
Fetiferous :: "Producing young  as animals."
Unison :: "A single  unvaried."
Lifeless :: "Destitute of life  or deprived of life; not containing  or inhabited by  living beings 
Zebra :: "Either one of two species of South African wild horses remarkable for having the body whit
Hemiplegia :: A palsy that affects one side only of the body.
Scandal :: To scandalize; to offend.
Girkin :: See Gherkin.
Unimplicate :: Not implicated.
Fly :: "To move in or pass thorugh the air with wings  as a bird."
Wanger :: A pillow for the cheek; a pillow.
Resubjection :: A second subjection.
Light :: "The time during which the light of the sun is visible; day; especially  the dawn of day."
Acuminate :: "To end in  or come to  a sharp point."
Recognize :: "To show appreciation of; as  to recognize services by a testimonial."
Jibber :: A horse that jibs.
Fizzle :: To make a ridiculous failure in an undertaking.
Frampel :: Alt. of Frampoid
Hither :: "Applied to time: On the hither side of  younger than; of fewer years than."
Hippodame :: A fabulous sea monster.
Remodification :: The act of remodifying; the state of being remodified.
Fibroid :: "Resembling or forming fibrous tissue; made up of fibers; as  fibroid tumors."
Fraction :: "The act of breaking  or state of being broken  especially by violence."
Flasket :: A vessel in which viands are served.
Hashed :: of Hash
Gauge :: The depth to which a vessel sinks in the water.
Gunner :: The great northern diver or loon. See Loon.
Rightful :: Righteous; upright; just; good; -- said of persons.
Footlicker :: A sycophant; a fawner; a toady.  Cf. Bootlick.
Earmark :: A mark for identification; a distinguishing mark.
Underset :: To prop or support.
Abolish :: "To put an end to  or destroy  as a physical objects; to wipe out."
Heyh :: Alt. of Heygh
Scatter :: "To be dispersed or dissipated; to disperse or separate; as  clouds scatter after a storm
Homopterous :: Of or pertaining to the Homoptera.
Abiding :: Continuing; lasting.
Unripeness :: Quality or state of being unripe.
Farce :: To render fat.
High :: "To rise; as  the sun higheth."
Residence :: "Subsidence  as of a sediment."
Gaul :: "The Anglicized form of Gallia  which in the time of the Romans included France and Upper It
Vein :: "A streak or wave of different color  appearing in wood  and in marble and other stones; var
Redoubt :: To stand in dread of; to regard with fear; to dread.
Nervous :: possessing nerve; sinewy; strong; vigorous.
Regard :: Consideration; thought; reflection; heed.
Germinal :: "Pertaining or belonging to a germ; as  the germinal vesicle."
Abuse :: To deceive; to impose on.
Gloss :: "An interpretation  consisting of one or more words  interlinear or marginal; an explanator
Scollop :: See Scallop.
Galaxy :: A splendid assemblage of persons or things.
Lay :: To cause to lie dead or dying.
Alkalimetry :: "The art or process of ascertaining the strength of alkalies  or the quantity present
Hig-taper :: A plant of the genus Verbascum (V. Thapsus); the common mullein. [Also high-taper and h
Leasow :: A pasture.
Hell :: "The place of the dead  or of souls after death; the grave; -- called in Hebrew sheol  and b
Harlech group :: A minor subdivision at the base of the Cambrian system in Wales.
Samphire :: The species of glasswort (Salicornia herbacea); -- called in England marsh samphire.
Hippocampus :: "A fabulous monster  with the head and fore quarters of a horse joined to the tail of
Scombroid :: "Any fish of the family Scombridae  of which the mackerel (Scomber) is the type."
lectern :: See Lecturn.
Rapeful :: Violent.
Leavenous :: Containing leaven.
Gypsy :: A cunning or crafty person
Greeter :: One who weeps or mourns.
Acidic :: Containing a high percentage of silica; -- opposed to basic.
Rubianic :: "pertaining to  or derived from  rubian; specifically  designating an acid called also r
Tafferer :: See Taffrail.
Acting :: Operating in any way.
Retrench :: "To cause or suffer retrenchment; specifically  to cut down living expenses; as  it is m
Accoy :: To subdue; to tame; to daunt.
Noiseless :: "Making  or causing  no noise or bustle; without noise; silent; as  the noiseless foot 
Furuncle :: "A superficial  inflammatory tumor  suppurating with a central core; a boil."
Ungracious :: Not well received; offensive; unpleasing; unacceptable; not favored.
Warrant :: To give a warrant or warranty to; to assure as if by giving a warrant to.
Pale :: That which incloses or fences in; a boundary; a limit; a fence; a palisade.
Hurled :: of Hurl
Kame :: A low ridge.
Recorded :: of Record
Unstockinged :: Destitute of stockings.
Rabid :: "Of or pertaining to rabies  or hydrophobia; as  rabid virus."
Scagliola :: "An imitation of any veined and ornamental stone  as marble  formed by a substratum of 
Zebrawood :: "A kind of cabinet wood having beautiful black  brown  and whitish stripes  the timber 
Harmonica :: "A toy instrument of strips of glass or metal hung on two tapes  and struck with hammer
Fumigate :: To smoke; to perfume.
Guinea :: "A gold coin of England current for twenty-one shillings sterling  or about five dollars  
Admirable :: Having qualities to excite wonder united with approbation; deserving the highest praise
Nehiloth :: "A term supposed to mean  perforated wind instruments of music  as pipes or flutes."
Hieromnemon :: "The sacred secretary or recorder sent by each state belonging to the Amphictyonic Co
Fady :: Faded.
Sea perch :: The cunner.
Hymenia :: of Hymenium
Hypocraterimorphous :: "Salver-shaped; having a slender tube  expanding suddenly above into a bowl-s
Ward :: A notch or slit in a key corresponding to a ridge in the lock which it fits; a ward notch.
Accompanying :: of Accompany
Furniture :: "The necessary appendages to anything  as to a machine  a carriage  a ship  etc."
Landwaiter :: "See Landing waiter  under Landing  a."
Hooked :: Provided with a hook or hooks.
Roof :: "To inclose in a house; figuratively  to shelter."
Unnervate :: Enervate.
Adventuress :: A female adventurer; a woman who tries to gain position by equivocal means.
Agree :: "To admit  or come to one mind concerning; to settle; to arrange; as  to agree the fact; to
Ready :: On the point; about; on the brink; near; -- with a following infinitive.
Headstock :: "The part of a lathe that holds the revolving spindle and its attachments; -- also call
Undersphere :: "An inferior sphere  or field of action."
Altarage :: "The profit which accrues to the priest  by reason of the altar  from the small tithes."
Light-winged :: Having light and active wings; volatile; fleeting.
Frustrate :: "To bring to nothing; to prevent from attaining a purpose; to disappoint; to defeat; to
Fulminated :: of Fulminate
Ally :: "Anything akin to another by structure  etc."
Uncock :: "To open or spread from a cock or heap  as hay."
Calciferous :: "Bearing  producing  or containing calcite  or carbonate of lime."
Unstring :: "To deprive of a string or strings; also  to take from a string; as  to unstring beads."
Keep :: To care; to desire.
Sanation :: The act of healing or curing.
Hard :: "Wanting softness or smoothness of utterance; harsh; as  a hard tone."
Retched :: of Retch
Aerially :: "Like  or from  the air; in an aerial manner."
Gemmaceous :: "Of or pertaining to gems or to gemmae; of the nature of  or resembling  gems or gemma
Legendary :: A book of legends; a tale or narrative.
Taenidia :: of Taenidium
Nationality :: Existence as a distinct or individual nation; national unity and integrity.
Lapidify :: To convert into stone or stony material; to petrify.
Giglot :: Giddi; light; inconstant; wanton.
Naufragous :: causing shipwreck.
Racket-tail :: "Any one of several species of humming birds of the genus Steganura  having two of th
Gleek :: "A game at cards  once popular  played by three persons."
Non-prossing :: of Non-pros
Nationality :: The sum of the qualities which distinguish a nation; national character.
Forslugge :: To lsoe by idleness or slotch.
Ecdyses :: of Ecdysis
Natty :: Neat; tidy; spruce.
Fine :: "A sum of money or price paid for obtaining a benefit  favor  or privilege  as for admission
Walk :: To move off; to depart.
Noduled :: Having little knots or lumps.
Hydrometallurgical :: Of or pertaining to hydrometallurgy; involving the use of liquid reagents in t
Veto :: "A power or right possessed by one department of government to forbid or prohibit the carryi
Forstraught :: Distracted.
Undergo :: "To be subjected to; to bear up against; to pass through; to endure; to suffer; to sustai
Underconsumption :: Consumption of less than is produced; consumption of less than the usual amount.
Heteromera :: "A division of Coleoptera  having heteromerous tarsi."
Grumble :: To murmur or mutter with discontent; to make ill-natured complaints in a low voice and a 
Absent :: Being away from a place; withdrawn from a place; not present.
Air :: The artificial motion or carriage of a horse.
Ventriculous :: Somewhat distended in the middle; ventricular.
Farced :: of Farce
Raveler :: One who ravels.
Vampire :: "A blood-sucking ghost; a soul of a dead person superstitiously believed to come from the
Paleotherian :: Of or pertaining to Paleotherium.
Salicylol :: Same as Salicylal.
Globeflower :: The American plant Trollius laxus.
Farcilite :: Pudding stone.
Scurrility :: "The quality or state of being scurrile or scurrilous; mean  vile  or obscene joculari
Jaw :: "Hence  also  the bone itself with the teeth and covering."
Ventrilocution :: Ventriloquism.
Sauroid :: "Resembling a saurian superficially; as  a sauroid fish."
Unfounded :: "Having no foundation; baseless; vain; idle; as  unfounded expectations."
Alas :: "An exclamation expressive of sorrow  pity  or apprehension of evil; -- in old writers  some
Scourage :: Refuse water after scouring.
Understock :: To supply insufficiently with stock.
Affeerment :: The act of affeering.
Free :: "Exempt; clear; released; liberated; not encumbered or troubled with; as  free from pain; fr
Addorsed :: Set or turned back to back.
Rixatrix :: A scolding or quarrelsome woman; a scold.
Golgotha :: Calvary. See the Note under Calvary.
Guaranty :: "In law and common usage: An undertaking to answer for the payment of some debt  or the 
Glycin :: Same as Glycocoll.
Fond :: "Loving; much pleased; affectionately regardful  indulgent  or desirous; longing or yearning
Hadj :: "The pilgrimage to Mecca  performed by Mohammedans."
Nebulosity :: The state or quality of being nebulous; cloudiness; hazeness; mistiness; nebulousness.
Fireside :: A place near the fire or hearth; home; domestic life or retirement.
Acquittance :: To acquit.
Forum :: A tribunal; a court; an assembly empowered to hear and decide causes.
Fat :: "Of a character which enables the compositor to make large wages; -- said of matter containin
Yellow-covered :: Covered or bound in yellow paper.
Garbed :: Dressed; habited; clad.
Force :: "Any action between two bodies which changes  or tends to change  their relative condition 
Unciform :: Having the shape of a hook; being of a curved or hooked from; hooklike.
Relumed :: of Relume
Froward :: "Not willing to yield or compIy with what is required or is reasonable; perverse; disobed
Heretog :: "The leader or commander of an army; also  a marshal."
Affrightment :: Affright; the state of being frightened; sudden fear or alarm.
Replevy :: "To take or get back  by a writ for that purpose (goods and chattels wrongfully taken or 
Franciscan :: Belonging to the Order of St. Francis of the Franciscans.
Keratome :: An instrument for dividing the cornea in operations for cataract.
Haemodromograph :: Same as Haemadromograph.
Fine :: "To make finer  or less coarse  as in bulk  texture  etc.; as. to fine the soil."
Relapser :: One who relapses.
Frescade :: A cool walk; shady place.
Rhabdocoelous :: Of or pertaining to the Rhabdocoela.
Hemi-demi-semiquaver :: "A short note  equal to one fourth of a semiquaver  or the sixty-fourth part
Lapse :: "To pass slowly and smoothly downward  backward  or away; to slip downward  backward  or aw
Faeces :: "Excrement; ordure; also  settlings; sediment after infusion or distillation."
Haired :: Having hair.
Lament :: "An elegy or mournful ballad  or the like."
Uro- :: "A combining form fr. Gr. o'y^ron  urine."
Salutatorily :: By way of salutation.
Nice :: "Apprehending slight differences or delicate distinctions; distinguishing accurately or minu
Retrace :: "To trace back  as a line."
Venge :: To avenge; to punish; to revenge.
Refractorily :: In a refractory manner; perversely; obstinately.
Schemata :: of Schema
Rummage :: To search a place narrowly.
Reposing :: of Repose
Utopianism :: "The ideas  views  aims  etc.  of a Utopian; impracticable schemes of human perfection
Unguestlike :: In a manner not becoming to a guest.
Garlanded :: of Garland
Fourth :: Next in order after the third; the ordinal of four.
Hog :: "To become bent upward in the middle  like a hog's back; -- said of a ship broken or strained
Tablespoon :: "A spoon of the largest size commonly used at the table; -- distinguished from teaspoo
Ruff :: "A variety of the domestic pigeon  having a ruff of its neck."
Forfeiture :: That which is forfeited; a penalty; a fine or mulct.
Aggest :: To heap up.
Nas :: Has not.
Garth :: A hoop or band.
Hit. :: "having become very popular or acclaimed; -- said of entertainment performances; as  a hit r
Uvitic :: "Pertaining to  or designating  an acid  CH3C6H3(CO2H)2  obtained as a white crystalline s
Gaster :: To gast.
Hagiographal :: "Pertaining to the hagiographa  or to sacred writings."
Laudable :: "Healthy; salubrious; normal; having a disposition to promote healing; not noxious; as  
Allectation :: Enticement; allurement.
Kan :: To know; to ken.
Leveful :: Allowable; permissible; lawful.
Resummons :: A second summons.
Headpiece :: Head.
Saan :: Same as Bushmen.
Scallop :: "Any one of numerous species of marine bivalve mollusks of the genus Pecten and allied ge
Gravel :: "To cover with gravel; as  to gravel a walk."
Recreation :: "The act of recreating  or the state of being recreated; refreshment of the strength a
Gallopading :: of Gallopade
Gentle :: "Quiet and refined in manners; not rough  harsh  or stern; mild; meek; bland; amiable; ten
Feverish :: "Indicating  or pertaining to  fever; characteristic of a fever; as  feverish symptoms."
General :: The public; the people; the vulgar.
Feeder :: One who fattens cattle for slaughter.
Unpedigreed :: Not distinguished by a pedigree.
Gilt :: Gilded; covered with gold; of the color of gold; golden yellow.
Aconite :: "The herb wolfsbane  or monkshood; -- applied to any plant of the genus Aconitum (tribe H
Neaf :: See 2d Neif.
Fabulist :: One who invents or writes fables.
Fluminous :: Pertaining to rivers; abounding in streama.
Nigh :: "Not remote in degree  kindred  circumstances  etc.; closely allied; intimate."
Recollet :: "Same as Recollect  n."
Ajar :: "Slightly turned or opened; as  the door was standing ajar."
Reflex :: "Of  pertaining to  or produced by  stimulus or excitation without the necessary intervent
Grapple :: A grappling iron.
Riveled :: of Rivel
Geognostic :: Alt. of Geognostical
Lavish :: "Superabundant; excessive; as  lavish spirits."
Calender :: "To press between rollers for the purpose of making smooth and glossy  or wavy  as woole
Neaped :: "Left aground on the height of a spring tide  so that it will not float till the next spri
Ketonic :: "Pertaining to  or derived from  a ketone; as  a ketonic acid."
Jumble :: To meet or unite in a confused way; to mix confusedly.
